Basic Features, employees	Basic Features
Basic Features, company age (months)	Basic Features
Basic Features, number of milestones in the CrunchBase profile	Basic Features
Basic Features, number of revisions on the company CrunchBase profile	Basic Features
Basic Features, number of TechCrunch articles about the company	Basic Features
Basic Features, number of competitors	Basic Features
Basic Features, number of competitors that got acquired	Basic Features
Basic Features, headquarter location	Basic Features
Basic Features, number of offices	Basic Features
Basic Features, number of products	Basic Features
Basic Features, number of providers	Basic Features
Financial Features, number of funding rounds	Financial Features
Financial Features, number of investments by the company	Financial Features
Financial Features, number of acquisitions by the company	Financial Features
Financial Features, number of venture capital firms investing in the company	Financial Features
Financial Features, number of private equity firms investing in the company	Financial Features
Financial Features, number of people with financial background investing in the company	Financial Features
Financial Features, number of key persons in the company with financial background	Financial Features
Financial Features, number of investors per funding round	Financial Features
Financial Features, amount of investment per funding round	Financial Features
Financial Features, amount of investment in this run	Financial Features
Managerial Features, number of companies founded by founders of the target company	Managerial Features
Managerial Features, number of successful companies by founders (being acquired or IPO)	Managerial Features
Managerial Features, founder's highest education	Managerial Features
Managerial Features, founder related experience (months)	Managerial Features
Managerial Features, associate with business side	Managerial Features
Managerial Features, technology side	Managerial Features
Managerial Features, sales side	Managerial Features
Managerial Features, marketing side	Managerial Features
Managerial Features, business development side	Managerial Features
Managerial Features, finance side	Managerial Features
Managerial Features, college ranking of the funder	Managerial Features
Managerial Features, founder's relationship to industry leader	Managerial Features
Managerial Features, degree of connections to industry leader	Managerial Features
Managerial Features, Innovation index for the funder (berkeley innovation index)	Managerial Features
Managerial Features, team skills sets	Managerial Features
Managerial Features, Team innovation index (Berkeley innovation index)	Managerial Features
Biotech Industry Segment, Food Industry	Biotech Industry Segment
Biotech Industry Segment, Animal Health	Biotech Industry Segment
Biotech Industry Segment, Pharmaceutical	Biotech Industry Segment
Biotech Industry Segment, Medical Decide	Biotech Industry Segment
Biotech Industry Segment, Diagnostics	Biotech Industry Segment
Biotech Industry Segment, Healthcare Services	Biotech Industry Segment
Food Industry, food	Food Industry
Animal Health, veterinary medicine	Animal Health
Animal Health, animal drug	Animal Health
Pharmaceutical, Pharmaceutical	Pharmaceutical
Pharmaceutical, therapeutic	Pharmaceutical
Pharmaceutical, drug	Pharmaceutical
Pharmaceutical, antibiotics	Pharmaceutical
Pharmaceutical, treatment	Pharmaceutical
Pharmaceutical, cure	Pharmaceutical
Pharmaceutical, therapy	Pharmaceutical
Medical Device, medical device	Medical Device
Medical Device, 510(k)	Medical Device
Medical Device, 90/385/EEC	Medical Device
Medical Device, 93/42/EEC	Medical Device
Medical Device, 98/79/EC	Medical Device
Medical Device, 21 CFR 860	Medical Device
Diagnostics, diagnostics	Diagnostics
Diagnostics, medical test	Diagnostics
Healthcare Services, healthcare service	Healthcare Services
Innovation Model, novel approach	Innovation Model
Innovation Model, fast-follower	Innovation Model
Innovation Model, bio-better	Innovation Model
Innovation Model, me-better	Innovation Model
Innovation Model, biosimilar	Innovation Model
Innovation Model, generic	Innovation Model
Innovation Model, new treatment	Innovation Model
Innovation Model, innovative	Innovation Model
Innovation Model, breakthrough	Innovation Model
Innovation Model, first-in-class	Innovation Model
Innovation Model, novel target	Innovation Model
Innovation Model, fast follow-on	Innovation Model
Innovation Model, biologics and best-in-class	Innovation Model
Innovation Model, best-in-class	Innovation Model
Innovation Model, biosimilar	Innovation Model
Innovation Model, generic	Innovation Model
Therapeutic Areas, Cardiovascular	Therapeutic Areas
Therapeutic Areas, Conditions originating in the perinatal period	Therapeutic Areas
Therapeutic Areas, Congenital malformations	Therapeutic Areas
Therapeutic Areas, deformations and chromosomal abnormalities	Therapeutic Areas
Therapeutic Areas, Digestive system	Therapeutic Areas
Therapeutic Areas, blood disease	Therapeutic Areas
Therapeutic Areas, Immune disease	Therapeutic Areas
Therapeutic Areas, Diseases of the ear	Therapeutic Areas
Therapeutic Areas, Diseases of the eye	Therapeutic Areas
Therapeutic Areas, Diseases of the nervous system	Therapeutic Areas
Therapeutic Areas, Endocrine	Therapeutic Areas
Therapeutic Areas, nutritional and metabolic diseases	Therapeutic Areas
Therapeutic Areas, Genitourinary system	Therapeutic Areas
Therapeutic Areas, Infectious and parasitic diseases	Therapeutic Areas
Therapeutic Areas, Injury	Therapeutic Areas
Therapeutic Areas, poisoning and certain other consequences of external causes	Therapeutic Areas
Therapeutic Areas, Mental and behavioural disorders	Therapeutic Areas
Therapeutic Areas, Musculoskeletal system and connective tissue	Therapeutic Areas
Therapeutic Areas, Neoplasms / cancer / oncology	Therapeutic Areas
Therapeutic Areas, Pregnancy	Therapeutic Areas
Therapeutic Areas, childbirth and the puerperium	Therapeutic Areas
Therapeutic Areas, Respiratory	Therapeutic Areas
Therapeutic Areas, Skin and subcutaneous tissue	Therapeutic Areas
Therapeutic Areas, Symptoms	Therapeutic Areas
Therapeutic Areas, signs and abnormal clinical and laboratory findings	Therapeutic Areas
Therapeutic Areas, not elsewhere classified	Therapeutic Areas
Cardiovascular, cardiovascular disease	Cardiovascular
Cardiovascular, coronary artery diseases	Cardiovascular
Cardiovascular, hypertension	Cardiovascular
Cardiovascular, myocardial infarction	Cardiovascular
Cardiovascular, angina	Cardiovascular
Cardiovascular, heart attack	Cardiovascular
Cardiovascular, stroke	Cardiovascular
Cardiovascular, heart failure	Cardiovascular
Cardiovascular, hypertensive heart disease	Cardiovascular
Cardiovascular, rheumatic heart disease	Cardiovascular
Cardiovascular, cardiomyopathy	Cardiovascular
Cardiovascular, heart arrhythmia	Cardiovascular
Cardiovascular, congenital heart disease	Cardiovascular
Cardiovascular, valvular heart disease	Cardiovascular
Cardiovascular, carditis	Cardiovascular
Cardiovascular, aortic aneurysms	Cardiovascular
Cardiovascular, peripheral artery disease	Cardiovascular
Cardiovascular, thromboembolic disease	Cardiovascular
Cardiovascular, venous thrombosis	Cardiovascular
Cardiovascular, atherosclerosis	Cardiovascular
Cardiovascular, Cerebrovascular disease	Cardiovascular
Cardiovascular, Renal artery stenosis	Cardiovascular
Cardiovascular, Pulmonary heart disease	Cardiovascular
Cardiovascular, Cardiac dysrhythmias	Cardiovascular
Cardiovascular, Endocarditis	Cardiovascular
Cardiovascular, Inflammatory cardiomegaly	Cardiovascular
Cardiovascular, Myocarditis	Cardiovascular
Cardiovascular, Eosinophilic myocarditis	Cardiovascular
Cardiovascular, 	Cardiovascular
Conditions originating in the perinatal period, PERINATAL Period	Conditions originating in the perinatal period
Congenital malformations, deformations and chromosomal abnormalities, congenital malformation	Congenital malformations, deformations and chromosomal abnormalities
Congenital malformations, deformations and chromosomal abnormalities, chromosomal abnormality	Congenital malformations, deformations and chromosomal abnormalities
Congenital malformations, deformations and chromosomal abnormalities, congenital deformation	Congenital malformations, deformations and chromosomal abnormalities
Digestive system, Gastrointestinal disease	Digestive system
Digestive system, GI disease	Digestive system
Digestive system, gingivitis	Digestive system
Digestive system, periodontitis	Digestive system
Digestive system, dental caries	Digestive system
Digestive system, Gastroesophageal reflux	Digestive system
Digestive system, Gardner's syndrome	Digestive system
Digestive system, Peutzâ€“Jeghers syndrome	Digestive system
Digestive system, Malabsorption	Digestive system
Digestive system, mouth ulcers	Digestive system
Digestive system, atrophic glossitis	Digestive system
Digestive system,  angular cheilitis	Digestive system
Digestive system, Crohn's disease	Digestive system
Digestive system, orofacial granulomatosis	Digestive system
Digestive system, Sideropenic dysphagia	Digestive system
Digestive system, glossitis	Digestive system
Digestive system, angular cheilitis	Digestive system
Digestive system, gastroesophageal reflux	Digestive system
Digestive system, oesophagitis	Digestive system
Digestive system, oesophageal varices	Digestive system
Digestive system, Boerhaave syndrome	Digestive system
Digestive system, Mallory-Weiss tears	Digestive system
Digestive system,  Zenker's diverticulum	Digestive system
Digestive system, esophageal webbing	Digestive system
Digestive system, oesophageal motility disorders	Digestive system
Digestive system, nutcracker oesophagus	Digestive system
Digestive system, achalasia	Digestive system
Digestive system, diffuse oesophageal spasm	Digestive system
Digestive system, oesophageal stricture	Digestive system
Digestive system,  gastritis	Digestive system
Digestive system, gastroenteritis	Digestive system
Digestive system, atrophic gastritis	Digestive system
Digestive system, pyloric stenosis	Digestive system
Digestive system, gastric cancer	Digestive system
Digestive system, gastric ulceration	Digestive system
Digestive system, peptic ulcers	Digestive system
Digestive system, Dieulafoy's lesion	Digestive system
Digestive system, Gastric antral vascular ectasia	Digestive system
Digestive system, Congenital disorder	Digestive system
Digestive system, pernicious anaemia	Digestive system
Digestive system, enterocolitis	Digestive system
Digestive system, infectious diarrhoea	Digestive system
Digestive system, mesenteric ischaemia	Digestive system
Digestive system, constipation	Digestive system
Digestive system, ileus	Digestive system
Digestive system, intussusception	Digestive system
Digestive system, volvulus	Digestive system
Digestive system,  intestinal pseudoobstruction	Digestive system
Digestive system, necrotizing enterocolitis	Digestive system
Digestive system, enteritis	Digestive system
Digestive system, duodenitis	Digestive system
Digestive system, jejunitis	Digestive system
Digestive system, ileitis	Digestive system
Digestive system, coeliac disease	Digestive system
Digestive system, infective Tropical sprue	Digestive system
Digestive system, short bowel syndrome	Digestive system
Digestive system, Curling's ulcer	Digestive system
Digestive system, blind loop syndrome	Digestive system
Digestive system, Milroy disease	Digestive system
Digestive system, Whipple's disease	Digestive system
Digestive system, gastrointestinal stromal tumours	Digestive system
Digestive system, lipomas	Digestive system
Digestive system, hamartomas	Digestive system
Digestive system, carcinoid syndromes	Digestive system
Digestive system, Appendicitis	Digestive system
Digestive system, colitis	Digestive system
Digestive system, Diverticulitis	Digestive system
Digestive system, colonic diseases	Digestive system
Digestive system, irritable bowel syndrome	Digestive system
Digestive system, intestinal pseudoobstruction	Digestive system
Digestive system, Hirschprung's disease	Digestive system
Digestive system, Hemorrhoids	Digestive system
Digestive system,  pruritus ani	Digestive system
Digestive system, ulcerative colitis	Digestive system
Digestive system, proctitis	Digestive system
Digestive system,  Faecal incontinence	Digestive system
Digestive system, encopresis	Digestive system
Digestive system, anal abscesses	Digestive system
Digestive system, small inflamed nodules	Digestive system
Digestive system, anal fissures	Digestive system
Digestive system, anal fistulas	Digestive system
Digestive system, Hepatitis	Digestive system
Digestive system, NASH	Digestive system
Digestive system, Alcoholic liver	Digestive system
Digestive system, hepatic fibrosis	Digestive system
Digestive system, hepatic fibrosis	Digestive system
Digestive system, liver failure	Digestive system
Digestive system, hepatic encephalopathy	Digestive system
Digestive system, hepatorenal syndrome	Digestive system
Digestive system, hemochromatosis	Digestive system
Digestive system, Wilson's disease	Digestive system
Digestive system, primary biliary cirrhosis	Digestive system
Digestive system, jaundice	Digestive system
Digestive system, Portal hypertension	Digestive system
Digestive system, oesophageal varices	Digestive system
Digestive system, haemorrhoids	Digestive system
Digestive system, exocrine pancreas	Digestive system
Digestive system, pancreatitis	Digestive system
Digestive system, pancreatic cancer	Digestive system
Digestive system, pancreatic pseudocysts	Digestive system
Digestive system, exocrine pancreatic insufficiency	Digestive system
Digestive system, pancreatic fistulas	Digestive system
Digestive system, cholecystolithiasis	Digestive system
Digestive system, choledocholithiasis	Digestive system
Digestive system, cholecystitis	Digestive system
Digestive system, cholangitis	Digestive system
Digestive system, Gastrointestinal bleeding	Digestive system
Digestive system, gastrointestinal disorder	Digestive system
Digestive system, dyspepsia	Digestive system
Digestive system, Belching	Digestive system
Digestive system, Rumination syndrome	Digestive system
Digestive system, abdominal bloating/distension	Digestive system
Digestive system, bowel syndrome	Digestive system
Digestive system, sphincter	Digestive system
Digestive system, Oddi disorder	Digestive system
Digestive system, Proctalgia fugax	Digestive system
Digestive system, Dyssynergic defecation	Digestive system
Digestive system, Cyclic vomiting syndrome	Digestive system
Digestive system, Infant colic	Digestive system
Digestive system, Functional diarrhea	Digestive system
Digestive system, Infant dyschezia	Digestive system
Digestive system, Aerophagia	Digestive system
Digestive system, Postprandial distress syndrome	Digestive system
Digestive system, Epigastric pain syndrome	Digestive system
blood disease, Anemias	blood disease
blood disease, Acanthocytosis	blood disease
blood disease, Alpha-thalassemia	blood disease
blood disease, Beta-thalassemia	blood disease
blood disease, Glucose-6-phosphate dehydrogenase deficiency	blood disease
blood disease, Hemoglobinopathy	blood disease
blood disease, Hereditary	blood disease
blood disease, Clostridium infection	blood disease
blood disease, Cholera infection	blood disease
blood disease, E. coli 0157:H7 infection	blood disease
blood disease, Typhoid fever	blood disease
blood disease, Leishmania infection	blood disease
blood disease, Malaria infection	blood disease
blood disease, Toxoplasmosis	blood disease
blood disease, Nonfamilial hypogammaglobulinemia	blood disease
blood disease, Selective deficiency of immunoglobulin	blood disease
blood disease, Immunodeficiency with increased immunoglobulin M	blood disease
blood disease, Antibody deficiency with near-normal immunoglobulins	blood disease
blood disease, hyperimmunoglobulinemia	blood disease
blood disease, hypogammaglobulinemia of infancyspherocytosis	blood disease
blood disease, Hereditary elliptocytosis	blood disease
blood disease, Hereditary pyropoikilocytosis	blood disease
blood disease, Cold hemagglutinin disease	blood disease
blood disease, Paroxysmal cold hemoglobinuria	blood disease
blood disease, Hemolytic-uremic syndrome	blood disease
blood disease, Hemolytic-uremic syndrome	blood disease
blood disease, Hereditary stomatocytosis	blood disease
blood disease, Hexokinase deficiency	blood disease
blood disease, Hyperanaemia	blood disease
blood disease, Ineffective erythropoiesis	blood disease
blood disease, Minkowski-Chauffard syndrome	blood disease
blood disease, Myelophthisic anemia	blood disease
blood disease, Neuroacanthocytosis	blood disease
blood disease, Chorea acanthocytosis	blood disease
blood disease, hemoglobinuria	blood disease
blood disease, Pyruvate kinase deficiency	blood disease
blood disease, Rh deficiency syndrome	blood disease
blood disease, Sickle-cell disease	blood disease
blood disease, ovalocytosis	blood disease
blood disease, Thalassemia	blood disease
blood disease, Triosephosphate isomerase deficiency	blood disease
blood disease, Lymphoma	blood disease
blood disease, reticuloendotheliosis	blood disease
blood disease, reticulosis	blood disease
blood disease, Microglioma	blood disease
blood disease, leukemia	blood disease
blood disease, Lymphomatoid granulomatosis	blood disease
blood disease, Acute erythraemia and erythroleukaemia	blood disease
blood disease, Acute erythremic myelosis	blood disease
blood disease, Heilmeyer-SchÃ¶ner disease	blood disease
blood disease, Panmyelosis	blood disease
blood disease, Acute panmyelosis with myelofibrosis	blood disease
blood disease, Polycythemia vera	blood disease
blood disease, myelofibrosis	blood disease
blood disease, myeloma	blood disease
blood disease, Kahler's disease	blood disease
blood disease, Myelomatosis	blood disease
blood disease, Plasmacytoma	blood disease
blood disease, Malignant plasma cell tumour NOS	blood disease
blood disease, Plasmacytoma NOS	blood disease
blood disease, Malignant Immunoproliferative Disease	blood disease
blood disease, Monoclonal gammopathy	blood disease
blood disease, T-gamma lymphoproliferative disease	blood disease
blood disease, WaldenstrÃ¶m's macroglobulinaemia	blood disease
blood disease, Alpha heavy chain disease	blood disease
blood disease, Gamma heavy chain disease	blood disease
blood disease, Franklin's disease	blood disease
blood disease, Immunoproliferative small intestinal disease	blood disease
blood disease, Mediterranean disease	blood disease
blood disease, Malignant immunoproliferative disease	blood disease
blood disease, Coagulation	blood disease
blood disease, purpura	blood disease
blood disease, hemorrhagic condition	blood disease
blood disease, Disseminated intravascular coagulation	blood disease
blood disease, Protein C deficiency	blood disease
blood disease, Protein S deficiency	blood disease
blood disease, Factor V Leiden	blood disease
blood disease, Thrombocytosis	blood disease
blood disease, Idiopathic thrombocytopenic purpura	blood disease
blood disease, thrombosis	blood disease
blood disease, Hemophilia	blood disease
blood disease, Von Willebrand disease	blood disease
blood disease, Antiphospholipid syndrome	blood disease
blood disease, Thrombocytopenia	blood disease
blood disease, Glanzmann's thrombasthenia	blood disease
blood disease, Wiskott-Aldrich syndrome	blood disease
blood disease, Thrombotic thrombocytopenic purpura	blood disease
Immune disease, lupus	Immune disease
Immune disease, Rheumatology	Immune disease
Immune disease, gastroenterology	Immune disease
Immune disease, Alopecia areata	Immune disease
Immune disease, celiac disease	Immune disease
Immune disease, Graves' disease	Immune disease
Immune disease, inflammatory bowel disease	Immune disease
Immune disease, multiple sclerosis	Immune disease
Immune disease, psoriasis	Immune disease
Immune disease, rheumatoid arthritis	Immune disease
Immune disease, systemic lupus erythematosus	Immune disease
Immune disease, Nonsteroidal anti-inflammatory drugs	Immune disease
Immune disease, immunosuppressants	Immune disease
Immune disease, autoimmunity	Immune disease
Immune disease, autoimmune disease	Immune disease
Immune disease, scleroderma	Immune disease
Immune disease, hemolytic anemia	Immune disease
Immune disease, vasculitis	Immune disease
Immune disease, type one diabetes	Immune disease
Immune disease, graves disease	Immune disease
Immune disease, goodpasture's syndrome	Immune disease
Immune disease, pernicious anemia	Immune disease
Immune disease, myopathy	Immune disease
Immune disease, lyme disease	Immune disease
Immune disease, primary immune deficiency	Immune disease
Immune disease, diseases	Immune disease
Immune disease, virus	Immune disease
Immune disease, pneumonia	Immune disease
Immune disease, bronchitis	Immune disease
Immune disease, sinusitis	Immune disease
Immune disease, severe combined immunodeficiency	Immune disease
Immune disease, digeorge syndrome	Immune disease
Immune disease, hyperimmunoglobulin e syndrome	Immune disease
Immune disease, common variable immunodeficiency	Immune disease
Immune disease, chronic granulomatous disease	Immune disease
Immune disease, nadph oxidase	Immune disease
Immune disease, wiskott-aldrich syndrome	Immune disease
Immune disease, autoimmune lymphoproliferative syndrome	Immune disease
Immune disease, hyper igm syndrome	Immune disease
Immune disease, leukocyte adhesion deficiency	Immune disease
Immune disease, selective immunoglobulin a deficiency	Immune disease
Immune disease, x-linked agammaglobulinemia	Immune disease
Immune disease, cell-mediated immunity	Immune disease
Immune disease, x-linked lymphoproliferative disease	Immune disease
Immune disease, ataxia-telangiectasia	Immune disease
Immune disease, seasonal allergy	Immune disease
Immune disease, mastocytosis	Immune disease
Immune disease, anaphylaxis	Immune disease
Immune disease, food allergy	Immune disease
Immune disease, allergic rhinitis	Immune disease
Immune disease, atopic dermatitis	Immune disease
Immune disease, immunity disorder	Immune disease
Immune disease, hypersplenism	Immune disease
Diseases of the ear, hearing loss	Diseases of the ear
Diseases of the ear, tinnitus	Diseases of the ear
Diseases of the ear, balance disorders	Diseases of the ear
Diseases of the ear, vertigo	Diseases of the ear
Diseases of the ear, eardrum	Diseases of the ear
Diseases of the ear, otoscope	Diseases of the ear
Diseases of the ear, outer ear	Diseases of the ear
Diseases of the ear, middle ear	Diseases of the ear
Diseases of the ear, inner ear	Diseases of the ear
Diseases of the ear, ear canal ,tympanic cavity	Diseases of the ear
Diseases of the ear, ossicles	Diseases of the ear
Diseases of the ear, eustachian tube	Diseases of the ear
Diseases of the ear, otolith	Diseases of the ear
Diseases of the ear, utricle	Diseases of the ear
Diseases of the ear, saccule	Diseases of the ear
Diseases of the ear, semicircular canals	Diseases of the ear
Diseases of the ear, vestibular system	Diseases of the ear
Diseases of the ear, cochlea	Diseases of the ear
Diseases of the ear, auditory system	Diseases of the ear
Diseases of the ear, pinna	Diseases of the ear
Diseases of the ear, tragus	Diseases of the ear
Diseases of the ear, antitragus	Diseases of the ear
Diseases of the ear, auditory bulla	Diseases of the ear
Diseases of the ear, tympanic part	Diseases of the ear
Diseases of the ear, temporal bone	Diseases of the ear
Diseases of the ear, ceruminous	Diseases of the ear
Diseases of the ear, sebaceous glands	Diseases of the ear
Diseases of the ear, auricular nerve	Diseases of the ear
Diseases of the ear, auriculotemporal nerve	Diseases of the ear
Diseases of the ear, greater occipital nerves	Diseases of the ear
Diseases of the ear, cervical plexus	Diseases of the ear
Diseases of the ear, tubercle	Diseases of the ear
Diseases of the ear, darwin's tubercle	Diseases of the ear
Diseases of the ear, earlobe	Diseases of the ear
Diseases of the ear, superior olivary complex	Diseases of the ear
Diseases of the ear, trapezoid bodies	Diseases of the ear
Diseases of the ear, malleus	Diseases of the ear
Diseases of the ear, incus	Diseases of the ear
Diseases of the ear, secondary tympanic membrane	Diseases of the ear
Diseases of the ear, cochlear	Diseases of the ear
Diseases of the ear, vestibulocochlear nerve	Diseases of the ear
Diseases of the ear, bony labyrinth	Diseases of the ear
Diseases of the ear, vestibule	Diseases of the ear
Diseases of the ear, membranous labyrinth	Diseases of the ear
Diseases of the ear, endolymph	Diseases of the ear
Diseases of the ear, vestibular duct	Diseases of the ear
Diseases of the ear, cochlear duct	Diseases of the ear
Diseases of the ear, tympanic duct	Diseases of the ear
Diseases of the ear, tensor tympani	Diseases of the ear
Diseases of the ear, stapedius	Diseases of the ear
Diseases of the ear, equilibrioception	Diseases of the ear
Diseases of the ear, kinocilium	Diseases of the ear
Diseases of the ear, otoliths	Diseases of the ear
Diseases of the ear, depolarisation	Diseases of the ear
Diseases of the ear, ampulla	Diseases of the ear
Diseases of the ear, cupula	Diseases of the ear
Diseases of the ear, vestibuloâ€“ocular reflex	Diseases of the ear
Diseases of the ear, embryogenesis	Diseases of the ear
Diseases of the ear, otic pit	Diseases of the ear
Diseases of the ear, otic vesicle	Diseases of the ear
Diseases of the ear, ductus reuniens	Diseases of the ear
Diseases of the ear, scala vestibuli	Diseases of the ear
Diseases of the ear, scala tympani	Diseases of the ear
Diseases of the ear, scala media	Diseases of the ear
Diseases of the ear, perilymph	Diseases of the ear
Diseases of the ear, vestibular membrane	Diseases of the ear
Diseases of the ear, basilar membrane	Diseases of the ear
Diseases of the ear, pharyngeal arches	Diseases of the ear
Diseases of the ear, pharyngeal pouch	Diseases of the ear
Diseases of the ear, pharynx	Diseases of the ear
Diseases of the ear, tubotympanic recess	Diseases of the ear
Diseases of the ear, pharyngeal cleft	Diseases of the ear
Diseases of the ear, otitis media	Diseases of the ear
Diseases of the ear, hearing aids	Diseases of the ear
Diseases of the ear, cochlear implants	Diseases of the ear
Diseases of the ear, atresia	Diseases of the ear
Diseases of the ear, microtia	Diseases of the ear
Diseases of the ear, otoplasty	Diseases of the ear
Diseases of the ear, annular stapedial ligament	Diseases of the ear
Diseases of the ear, benign paroxysmal positional vertigo	Diseases of the ear
Diseases of the ear, mÃ©niÃ¨re's disease	Diseases of the ear
Diseases of the ear, labyrinthitis	Diseases of the ear
Diseases of the ear, laceration	Diseases of the ear
Diseases of the ear, avulsion injuries	Diseases of the ear
Diseases of the ear, cauliflower ear	Diseases of the ear
Diseases of the ear, haematoma	Diseases of the ear
Diseases of the ear, perichondrium	Diseases of the ear
Diseases of the ear, barotrauma	Diseases of the ear
Diseases of the ear, otorrhea	Diseases of the ear
Diseases of the ear, otoscopy	Diseases of the ear
Diseases of the eye, ectropion	Diseases of the eye
Diseases of the eye, lagophthalmos	Diseases of the eye
Diseases of the eye, blepharochalasis	Diseases of the eye
Diseases of the eye, ptosis	Diseases of the eye
Diseases of the eye, stye	Diseases of the eye
Diseases of the eye, xanthelasma	Diseases of the eye
Diseases of the eye, leishmaniasis	Diseases of the eye
Diseases of the eye, loiasis	Diseases of the eye
Diseases of the eye, onchocerciasis	Diseases of the eye
Diseases of the eye, phthiriasis	Diseases of the eye
Diseases of the eye, dacryoadenitis	Diseases of the eye
Diseases of the eye, epiphora	Diseases of the eye
Diseases of the eye, exophthalmos	Diseases of the eye
Diseases of the eye, conjunctivitis	Diseases of the eye
Diseases of the eye, scleritis	Diseases of the eye
Diseases of the eye, sclera	Diseases of the eye
Diseases of the eye, keratitis	Diseases of the eye
Diseases of the eye, cornea	Diseases of the eye
Diseases of the eye, corneal ulcer	Diseases of the eye
Diseases of the eye, corneal abrasion	Diseases of the eye
Diseases of the eye, snow blindness	Diseases of the eye
Diseases of the eye, arc eye	Diseases of the eye
Diseases of the eye, thygeson's superficial punctate keratopathy	Diseases of the eye
Diseases of the eye, corneal neovascularization	Diseases of the eye
Diseases of the eye, fuchs' dystrophy	Diseases of the eye
Diseases of the eye, keratoconus	Diseases of the eye
Diseases of the eye, keratoconjunctivitis sicca	Diseases of the eye
Diseases of the eye, iritis	Diseases of the eye
Diseases of the eye, iris	Diseases of the eye
Diseases of the eye, uveitis	Diseases of the eye
Diseases of the eye, sympathetic ophthalmia	Diseases of the eye
Diseases of the eye, cataract	Diseases of the eye
Diseases of the eye, chorioretinal	Diseases of the eye
Diseases of the eye, chorioretinitis	Diseases of the eye
Diseases of the eye, choroiditis	Diseases of the eye
Diseases of the eye, retinitis	Diseases of the eye
Diseases of the eye, retinochoroiditis	Diseases of the eye
Diseases of the eye, disseminated	Diseases of the eye
Diseases of the eye, exudative	Diseases of the eye
Diseases of the eye, retinopathy	Diseases of the eye
Diseases of the eye, posterior cyclitis	Diseases of the eye
Diseases of the eye, pars planitis	Diseases of the eye
Diseases of the eye, inflammations	Diseases of the eye
Diseases of the eye, harada's disease	Diseases of the eye
Diseases of the eye, choroid	Diseases of the eye
Diseases of the eye, scars	Diseases of the eye
Diseases of the eye, macula	Diseases of the eye
Diseases of the eye, posterior pole	Diseases of the eye
Diseases of the eye, inflammatory	Diseases of the eye
Diseases of the eye, traumatic	Diseases of the eye
Diseases of the eye, solar retinopathy	Diseases of the eye
Diseases of the eye, choroidal	Diseases of the eye
Diseases of the eye, angioid streaks	Diseases of the eye
Diseases of the eye, choroideremia	Diseases of the eye
Diseases of the eye, areolar	Diseases of the eye
Diseases of the eye, peripapillary	Diseases of the eye
Diseases of the eye, gyrate atrophy	Diseases of the eye
Diseases of the eye, ornithinaemia	Diseases of the eye
Diseases of the eye, haemorrhage	Diseases of the eye
Diseases of the eye, toxoplasma	Diseases of the eye
Diseases of the eye, retinal detachment	Diseases of the eye
Diseases of the eye, retina	Diseases of the eye
Diseases of the eye, distorted vision	Diseases of the eye
Diseases of the eye, retinoschisis	Diseases of the eye
Diseases of the eye, hypertensive retinopathy	Diseases of the eye
Diseases of the eye, diabetic retinopathy	Diseases of the eye
Diseases of the eye, retinopathy of prematurity	Diseases of the eye
Diseases of the eye, age-related macular degeneration	Diseases of the eye
Diseases of the eye, macular degeneration	Diseases of the eye
Diseases of the eye, bull's eye maculopathy	Diseases of the eye
Diseases of the eye, epiretinal membrane	Diseases of the eye
Diseases of the eye, peripheral	Diseases of the eye
Diseases of the eye, retinal	Diseases of the eye
Diseases of the eye, hereditary	Diseases of the eye
Diseases of the eye, retinitis pigmentosa	Diseases of the eye
Diseases of the eye, retinal haemorrhage	Diseases of the eye
Diseases of the eye, retinal layers	Diseases of the eye
Diseases of the eye, central serous retinopathy	Diseases of the eye
Diseases of the eye, retinal disorders	Diseases of the eye
Diseases of the eye, macular edema	Diseases of the eye
Diseases of the eye, retinal disorder	Diseases of the eye
Diseases of the eye, glaucoma	Diseases of the eye
Diseases of the eye, optic neuropathy	Diseases of the eye
Diseases of the eye, ocular hypertension	Diseases of the eye
Diseases of the eye, open-angle glaucoma	Diseases of the eye
Diseases of the eye, angle-closure glaucoma	Diseases of the eye
Diseases of the eye, normal tension glaucoma	Diseases of the eye
Diseases of the eye, floaters	Diseases of the eye
Diseases of the eye, leber's hereditary optic neuropathy	Diseases of the eye
Diseases of the eye, optic disc drusen	Diseases of the eye
Diseases of the eye, strabismus	Diseases of the eye
Diseases of the eye, ophthalmoparesis	Diseases of the eye
Diseases of the eye, eye muscles	Diseases of the eye
Diseases of the eye, progressive external ophthaloplegia	Diseases of the eye
Diseases of the eye, esotropia	Diseases of the eye
Diseases of the eye, exotropia	Diseases of the eye
Diseases of the eye, disorders of refraction	Diseases of the eye
Diseases of the eye, accommodation	Diseases of the eye
Diseases of the eye, hypermetropia	Diseases of the eye
Diseases of the eye, myopia	Diseases of the eye
Diseases of the eye, astigmatism	Diseases of the eye
Diseases of the eye, anisometropia	Diseases of the eye
Diseases of the eye, presbyopia	Diseases of the eye
Diseases of the eye, ophthalmoplegia	Diseases of the eye
Diseases of the eye, amblyopia	Diseases of the eye
Diseases of the eye, leber's congenital amaurosis	Diseases of the eye
Diseases of the eye, scotoma	Diseases of the eye
Diseases of the eye, anopsia	Diseases of the eye
Diseases of the eye, color blindness	Diseases of the eye
Diseases of the eye, achromatopsia	Diseases of the eye
Diseases of the eye, maskun	Diseases of the eye
Diseases of the eye, cone cells	Diseases of the eye
Diseases of the eye, nyctalopia	Diseases of the eye
Diseases of the eye, blindness	Diseases of the eye
Diseases of the eye, river blindness	Diseases of the eye
Diseases of the eye, micropthalmia	Diseases of the eye
Diseases of the eye, coloboma	Diseases of the eye
Diseases of the eye, optic nerve	Diseases of the eye
Diseases of the eye, brain	Diseases of the eye
Diseases of the eye, spinal cord	Diseases of the eye
Diseases of the eye, red eye	Diseases of the eye
Diseases of the eye, argyll robertson pupil	Diseases of the eye
Diseases of the eye, xerophthalmia	Diseases of the eye
Diseases of the eye, aniridia	Diseases of the eye
Diseases of the eye, endophthalmitis	Diseases of the eye
Diseases of the eye, corneal dystrophies in human	Diseases of the eye
Diseases of the eye, corrective lenses	Diseases of the eye
Diseases of the eye, chalazion	Diseases of the eye
Diseases of the eye, blepharitis	Diseases of the eye
Diseases of the eye, entropion	Diseases of the eye
Diseases of the eye, blepharophimosis	Diseases of the eye
Diseases of the eye, trichiasis	Diseases of the eye
Diseases of the eye, madarosis	Diseases of the eye
Diseases of the eye, lacrimal apparatus	Diseases of the eye
Diseases of the eye, dacryocystitis	Diseases of the eye
Diseases of the eye, enophthalmos	Diseases of the eye
Diseases of the eye, orbital cellulitis	Diseases of the eye
Diseases of the eye, periorbital cellulitis	Diseases of the eye
Diseases of the eye, pterygium	Diseases of the eye
Diseases of the eye, pinguecula	Diseases of the eye
Diseases of the eye, subconjunctival hemorrhage	Diseases of the eye
Diseases of the eye, fibrous tunic	Diseases of the eye
Diseases of the eye, episcleritis	Diseases of the eye
Diseases of the eye, herpetic	Diseases of the eye
Diseases of the eye, acanthamoebic	Diseases of the eye
Diseases of the eye, corneal dystrophy	Diseases of the eye
Diseases of the eye, meesmann	Diseases of the eye
Diseases of the eye, corneal ectasia	Diseases of the eye
Diseases of the eye, pellucid marginal degeneration	Diseases of the eye
Diseases of the eye, keratoglobus	Diseases of the eye
Diseases of the eye, terrien's marginal degeneration	Diseases of the eye
Diseases of the eye, post-lasik ectasia	Diseases of the eye
Diseases of the eye, keratoconjunctivitis	Diseases of the eye
Diseases of the eye, sicca	Diseases of the eye
Diseases of the eye, kayserâ€“fleischer ring	Diseases of the eye
Diseases of the eye, haab's striae	Diseases of the eye
Diseases of the eye, arcus senilis	Diseases of the eye
Diseases of the eye, band keratopathy	Diseases of the eye
Diseases of the eye, vascular tunic	Diseases of the eye
Diseases of the eye, ciliary body	Diseases of the eye
Diseases of the eye, intermediate uveitis	Diseases of the eye
Diseases of the eye, hyphema	Diseases of the eye
Diseases of the eye, rubeosis iridis	Diseases of the eye
Diseases of the eye, persistent pupillary membrane	Diseases of the eye
Diseases of the eye, iridodialysis	Diseases of the eye
Diseases of the eye, synechia	Diseases of the eye
Diseases of the eye, congenital cataract	Diseases of the eye
Diseases of the eye, childhood cataract	Diseases of the eye
Diseases of the eye, aphakia	Diseases of the eye
Diseases of the eye, ectopia lentis	Diseases of the eye
Diseases of the eye, cytomegalovirus retinitis	Diseases of the eye
Diseases of the eye, ocular ischemic syndrome	Diseases of the eye
Diseases of the eye, central retinal vein occlusion	Diseases of the eye
Diseases of the eye, central retinal artery occlusion	Diseases of the eye
Diseases of the eye, branch retinal artery occlusion	Diseases of the eye
Diseases of the eye, purtscher's	Diseases of the eye
Diseases of the eye, of prematurity	Diseases of the eye
Diseases of the eye, bietti's crystalline dystrophy	Diseases of the eye
Diseases of the eye, coats' disease	Diseases of the eye
Diseases of the eye, vitelliform macular dystrophy	Diseases of the eye
Diseases of the eye, birdshot chorioretinopathy	Diseases of the eye
Diseases of the eye, primary juvenile glaucoma	Diseases of the eye
Diseases of the eye, floater	Diseases of the eye
Diseases of the eye, globe rupture	Diseases of the eye
Diseases of the eye, phthisis bulbi	Diseases of the eye
Diseases of the eye, persistent fetal vasculature	Diseases of the eye
Diseases of the eye, persistent hyperplastic primary vitreous	Diseases of the eye
Diseases of the eye, persistent tunica vasculosa lentis	Diseases of the eye
Diseases of the eye, familial exudative vitreoretinopathy	Diseases of the eye
Diseases of the eye, pathways	Diseases of the eye
Diseases of the eye, optic disc	Diseases of the eye
Diseases of the eye, optic neuritis	Diseases of the eye
Diseases of the eye, optic papillitis	Diseases of the eye
Diseases of the eye, papilledema	Diseases of the eye
Diseases of the eye, foster kennedy syndrome	Diseases of the eye
Diseases of the eye, optic atrophy	Diseases of the eye
Diseases of the eye, ischemic	Diseases of the eye
Diseases of the eye, anteriorÂ (aion),posteriorÂ (pion),kjer's	Diseases of the eye
Diseases of the eye, leber's hereditary	Diseases of the eye
Diseases of the eye, binocular vision	Diseases of the eye
Diseases of the eye, paralytic strabismus	Diseases of the eye
Diseases of the eye, chronic progressive external ophthalmoplegia	Diseases of the eye
Diseases of the eye, kearnsâ€“sayre syndrome	Diseases of the eye
Diseases of the eye, palsies	Diseases of the eye
Diseases of the eye, oculomotor	Diseases of the eye
Diseases of the eye, hypertropia	Diseases of the eye
Diseases of the eye, heterophoria	Diseases of the eye
Diseases of the eye, esophoria	Diseases of the eye
Diseases of the eye, exophoria	Diseases of the eye
Diseases of the eye, cyclotropia	Diseases of the eye
Diseases of the eye, brown's syndrome	Diseases of the eye
Diseases of the eye, duane syndrome	Diseases of the eye
Diseases of the eye, conjugate gaze palsy	Diseases of the eye
Diseases of the eye, convergence insufficiency	Diseases of the eye
Diseases of the eye, internuclear ophthalmoplegia	Diseases of the eye
Diseases of the eye, one and a half syndrome	Diseases of the eye
Diseases of the eye, hyperopia	Diseases of the eye
Diseases of the eye, aniseikonia	Diseases of the eye
Diseases of the eye, vision disorders	Diseases of the eye
Diseases of the eye, diplopia	Diseases of the eye
Diseases of the eye, dichromacy	Diseases of the eye
Diseases of the eye, monochromacy	Diseases of the eye
Diseases of the eye, oguchi disease	Diseases of the eye
Diseases of the eye, vision loss	Diseases of the eye
Diseases of the eye, visual impairment	Diseases of the eye
Diseases of the eye, hemianopsia	Diseases of the eye
Diseases of the eye, binasal	Diseases of the eye
Diseases of the eye, bitemporal	Diseases of the eye
Diseases of the eye, quadrantanopia	Diseases of the eye
Diseases of the eye, asthenopia	Diseases of the eye
Diseases of the eye, hemeralopia	Diseases of the eye
Diseases of the eye, photophobia	Diseases of the eye
Diseases of the eye, scintillating scotoma	Diseases of the eye
Diseases of the eye, anisocoria	Diseases of the eye
Diseases of the eye, marcus gunn pupil	Diseases of the eye
Diseases of the eye, adie syndrome	Diseases of the eye
Diseases of the eye, mydriasis	Diseases of the eye
Diseases of the eye, cycloplegia	Diseases of the eye
Diseases of the eye, parinaud's syndrome	Diseases of the eye
Diseases of the eye, nystagmus	Diseases of the eye
Diseases of the eye, childhood blindness	Diseases of the eye
Diseases of the eye, infections	Diseases of the eye
Diseases of the eye, trachoma	Diseases of the eye
Diseases of the eye, congenital	Diseases of the eye
Diseases of the eye, distichia	Diseases of the eye
Diseases of the eye, ablepharon	Diseases of the eye
Diseases of the eye, marcus gunn phenomenon	Diseases of the eye
Diseases of the eye, congenital lacrimal duct obstruction	Diseases of the eye
Diseases of the eye, anophthalmia	Diseases of the eye
Diseases of the eye, cystic eyeball	Diseases of the eye
Diseases of the eye, cryptophthalmos	Diseases of the eye
Diseases of the eye, microphthalmia	Diseases of the eye
Diseases of the eye, anterior segment	Diseases of the eye
Diseases of the eye, axenfeld syndrome	Diseases of the eye
Diseases of the eye, megalocornea	Diseases of the eye
Diseases of the eye, buphthalmos	Diseases of the eye
Diseases of the eye, coloboma of optic nerve	Diseases of the eye
Diseases of the eye, hydrophthalmos	Diseases of the eye
Diseases of the eye, norrie disease	Diseases of the eye
Diseases of the nervous system, neurosurgery	Diseases of the nervous system
Diseases of the nervous system, neurological disorders	Diseases of the nervous system
Diseases of the nervous system, traumatic brain injury	Diseases of the nervous system
Diseases of the nervous system, list of central nervous system infections	Diseases of the nervous system
Diseases of the nervous system, hypospadias	Diseases of the nervous system
Diseases of the nervous system, spina bifida	Diseases of the nervous system
Diseases of the nervous system, microgyria	Diseases of the nervous system
Diseases of the nervous system, polymicrogyria	Diseases of the nervous system
Diseases of the nervous system, bilateral frontoparietal polymicrogyria	Diseases of the nervous system
Diseases of the nervous system, pachygyria	Diseases of the nervous system
Diseases of the nervous system, arachnoid cysts	Diseases of the nervous system
Diseases of the nervous system, cerebrospinal fluid	Diseases of the nervous system
Diseases of the nervous system, congenital disorder	Diseases of the nervous system
Diseases of the nervous system, ataxia	Diseases of the nervous system
Diseases of the nervous system, hemiparesis	Diseases of the nervous system
Diseases of the nervous system, macrocephaly	Diseases of the nervous system
Diseases of the nervous system, adhd	Diseases of the nervous system
Diseases of the nervous system, hydrocephalus	Diseases of the nervous system
Diseases of the nervous system, urinary incontinence	Diseases of the nervous system
Diseases of the nervous system, attention deficit-hyperactivity disorder	Diseases of the nervous system
Diseases of the nervous system, dopamine	Diseases of the nervous system
Diseases of the nervous system, dementia with lewy bodies	Diseases of the nervous system
Diseases of the nervous system, attention deficit disorder	Diseases of the nervous system
Diseases of the nervous system, parkinson's disease	Diseases of the nervous system
Diseases of the nervous system, autism	Diseases of the nervous system
Diseases of the nervous system, bipolar disorder	Diseases of the nervous system
Diseases of the nervous system, catalepsy	Diseases of the nervous system
Diseases of the nervous system, epilepsy	Diseases of the nervous system
Diseases of the nervous system, benzodiazepines	Diseases of the nervous system
Diseases of the nervous system, lorazepam	Diseases of the nervous system
Diseases of the nervous system, major depressive disorder	Diseases of the nervous system
Diseases of the nervous system, locked-in syndrome	Diseases of the nervous system
Diseases of the nervous system, meningitis	Diseases of the nervous system
Diseases of the nervous system, meninges	Diseases of the nervous system
Diseases of the nervous system, migraine	Diseases of the nervous system
Diseases of the nervous system, neurological disorder	Diseases of the nervous system
Diseases of the nervous system, multiple sclerosis	Diseases of the nervous system
Diseases of the nervous system, demyelinating disease	Diseases of the nervous system
Diseases of the nervous system, myelin sheath	Diseases of the nervous system
Diseases of the nervous system, depression	Diseases of the nervous system
Diseases of the nervous system, myelopathy	Diseases of the nervous system
Diseases of the nervous system, alzheimer's disease	Diseases of the nervous system
Diseases of the nervous system, neurodegenerative	Diseases of the nervous system
Diseases of the nervous system, dementia	Diseases of the nervous system
Diseases of the nervous system, huntington's disease	Diseases of the nervous system
Diseases of the nervous system, striatum	Diseases of the nervous system
Diseases of the nervous system, bradykinesia	Diseases of the nervous system
Diseases of the nervous system, seborrheic dermatitis	Diseases of the nervous system
Diseases of the nervous system, attention deficit/hyperactivity disorder	Diseases of the nervous system
Diseases of the nervous system, bi-polar disorder	Diseases of the nervous system
Diseases of the nervous system, tourette's syndrome	Diseases of the nervous system
Diseases of the nervous system, neural rehabilitation	Diseases of the nervous system
Diseases of the nervous system, neurodegenerative disease	Diseases of the nervous system
Endocrine, nutritional and metabolic diseases, iodine-deficiency	Endocrine, nutritional and metabolic diseases
Endocrine, nutritional and metabolic diseases, goitre	Endocrine, nutritional and metabolic diseases
Endocrine, nutritional and metabolic diseases,  hypothyroidism	Endocrine, nutritional and metabolic diseases
Endocrine, nutritional and metabolic diseases, myxoedema coma	Endocrine, nutritional and metabolic diseases
Endocrine, nutritional and metabolic diseases, thyrotoxicosis	Endocrine, nutritional and metabolic diseases
Endocrine, nutritional and metabolic diseases, hyperthyroidism	Endocrine, nutritional and metabolic diseases
Endocrine, nutritional and metabolic diseases, graves' disease	Endocrine, nutritional and metabolic diseases
Endocrine, nutritional and metabolic diseases, toxic single thyroid nodule	Endocrine, nutritional and metabolic diseases
Endocrine, nutritional and metabolic diseases, thyrotoxicosis factitia	Endocrine, nutritional and metabolic diseases
Endocrine, nutritional and metabolic diseases, thyroid crisis	Endocrine, nutritional and metabolic diseases
Endocrine, nutritional and metabolic diseases, thyroiditis	Endocrine, nutritional and metabolic diseases
Endocrine, nutritional and metabolic diseases, hypersecretion of calcitonin	Endocrine, nutritional and metabolic diseases
Endocrine, nutritional and metabolic diseases, sick-euthyroid syndrome	Endocrine, nutritional and metabolic diseases
Endocrine, nutritional and metabolic diseases, diabetic	Endocrine, nutritional and metabolic diseases
Endocrine, nutritional and metabolic diseases, diabetes	Endocrine, nutritional and metabolic diseases
Endocrine, nutritional and metabolic diseases, drug-induced insulin coma in nondiabetic	Endocrine, nutritional and metabolic diseases
Endocrine, nutritional and metabolic diseases, hyperinsulinism	Endocrine, nutritional and metabolic diseases
Endocrine, nutritional and metabolic diseases, hypoglycaemic coma	Endocrine, nutritional and metabolic diseases
Endocrine, nutritional and metabolic diseases, pancreatic internal secretion	Endocrine, nutritional and metabolic diseases
Endocrine, nutritional and metabolic diseases, drug-induced hypoglycaemia	Endocrine, nutritional and metabolic diseases
Endocrine, nutritional and metabolic diseases, coma	Endocrine, nutritional and metabolic diseases
Endocrine, nutritional and metabolic diseases, hypoglycaemia	Endocrine, nutritional and metabolic diseases
Endocrine, nutritional and metabolic diseases, functional nonhyperinsulinaemic hypoglycaemia	Endocrine, nutritional and metabolic diseases
Endocrine, nutritional and metabolic diseases, hyperplasia of pancreatic islet beta cells	Endocrine, nutritional and metabolic diseases
Endocrine, nutritional and metabolic diseases, posthypoglycaemic coma encephalopathy	Endocrine, nutritional and metabolic diseases
Endocrine, nutritional and metabolic diseases, hypergastrinaemia	Endocrine, nutritional and metabolic diseases
Endocrine, nutritional and metabolic diseases, zollinger-ellison syndrome	Endocrine, nutritional and metabolic diseases
Endocrine, nutritional and metabolic diseases, hypoparathyroidism	Endocrine, nutritional and metabolic diseases
Endocrine, nutritional and metabolic diseases, pseudohypoparathyroidism	Endocrine, nutritional and metabolic diseases
Endocrine, nutritional and metabolic diseases, hyperparathyroidism	Endocrine, nutritional and metabolic diseases
Endocrine, nutritional and metabolic diseases, parathyroid gland	Endocrine, nutritional and metabolic diseases
Endocrine, nutritional and metabolic diseases, primary hyperparathyroidism	Endocrine, nutritional and metabolic diseases
Endocrine, nutritional and metabolic diseases, secondary hyperparathyroidism	Endocrine, nutritional and metabolic diseases
Endocrine, nutritional and metabolic diseases, acromegaly	Endocrine, nutritional and metabolic diseases
Endocrine, nutritional and metabolic diseases, pituitary gigantism	Endocrine, nutritional and metabolic diseases
Endocrine, nutritional and metabolic diseases, hyperprolactinaemia	Endocrine, nutritional and metabolic diseases
Endocrine, nutritional and metabolic diseases, syndrome of inappropriate secretion of antidiuretic hormone	Endocrine, nutritional and metabolic diseases
Endocrine, nutritional and metabolic diseases, precocious puberty	Endocrine, nutritional and metabolic diseases
Endocrine, nutritional and metabolic diseases, hypopituitarism	Endocrine, nutritional and metabolic diseases
Endocrine, nutritional and metabolic diseases, fertile eunuch syndrome	Endocrine, nutritional and metabolic diseases
Endocrine, nutritional and metabolic diseases, hypogonadotropic hypogonadism	Endocrine, nutritional and metabolic diseases
Endocrine, nutritional and metabolic diseases, idiopathic growth hormone deficiency	Endocrine, nutritional and metabolic diseases
Endocrine, nutritional and metabolic diseases, gonadotropin	Endocrine, nutritional and metabolic diseases
Endocrine, nutritional and metabolic diseases, growth hormone	Endocrine, nutritional and metabolic diseases
Endocrine, nutritional and metabolic diseases, pituitary hormone	Endocrine, nutritional and metabolic diseases
Endocrine, nutritional and metabolic diseases, kallmann's syndrome	Endocrine, nutritional and metabolic diseases
Endocrine, nutritional and metabolic diseases, lorain-levi short stature	Endocrine, nutritional and metabolic diseases
Endocrine, nutritional and metabolic diseases, necrosis	Endocrine, nutritional and metabolic diseases
Endocrine, nutritional and metabolic diseases, ppanhypopituitarism	Endocrine, nutritional and metabolic diseases
Endocrine, nutritional and metabolic diseases, cachexia	Endocrine, nutritional and metabolic diseases
Endocrine, nutritional and metabolic diseases, pituitary insufficiency	Endocrine, nutritional and metabolic diseases
Endocrine, nutritional and metabolic diseases, short stature	Endocrine, nutritional and metabolic diseases
Endocrine, nutritional and metabolic diseases, sheehan's syndrome	Endocrine, nutritional and metabolic diseases
Endocrine, nutritional and metabolic diseases, simmonds' disease	Endocrine, nutritional and metabolic diseases
Endocrine, nutritional and metabolic diseases, diabetes insipidus	Endocrine, nutritional and metabolic diseases
Endocrine, nutritional and metabolic diseases, hypothalamic dysfunction	Endocrine, nutritional and metabolic diseases
Endocrine, nutritional and metabolic diseases, abscess of pituitary	Endocrine, nutritional and metabolic diseases
Endocrine, nutritional and metabolic diseases, adiposogenital dystrophy	Endocrine, nutritional and metabolic diseases
Endocrine, nutritional and metabolic diseases, cushing's syndrome	Endocrine, nutritional and metabolic diseases
Endocrine, nutritional and metabolic diseases, pituitary-dependent cushing's disease	Endocrine, nutritional and metabolic diseases
Endocrine, nutritional and metabolic diseases, nelson's syndrome	Endocrine, nutritional and metabolic diseases
Endocrine, nutritional and metabolic diseases, ectopic acth syndrome	Endocrine, nutritional and metabolic diseases
Endocrine, nutritional and metabolic diseases, pseudo-cushing's syndrome	Endocrine, nutritional and metabolic diseases
Endocrine, nutritional and metabolic diseases, adrenogenital disorders	Endocrine, nutritional and metabolic diseases
Endocrine, nutritional and metabolic diseases, congenital adrenogenital disorders	Endocrine, nutritional and metabolic diseases
Endocrine, nutritional and metabolic diseases, enzyme deficiency	Endocrine, nutritional and metabolic diseases
Endocrine, nutritional and metabolic diseases, congenital adrenal hyperplasia	Endocrine, nutritional and metabolic diseases
Endocrine, nutritional and metabolic diseases, congenital adrenal hyperplasia due to 21-hydroxylase deficiency	Endocrine, nutritional and metabolic diseases
Endocrine, nutritional and metabolic diseases, hyperaldosteronism	Endocrine, nutritional and metabolic diseases
Endocrine, nutritional and metabolic diseases, primary hyperaldosteronism	Endocrine, nutritional and metabolic diseases
Endocrine, nutritional and metabolic diseases, conn's syndrome	Endocrine, nutritional and metabolic diseases
Endocrine, nutritional and metabolic diseases, primary aldosteronism due to adrenal hyperplasia	Endocrine, nutritional and metabolic diseases
Endocrine, nutritional and metabolic diseases, secondary hyperaldosteronism	Endocrine, nutritional and metabolic diseases
Endocrine, nutritional and metabolic diseases, bartter's syndrome	Endocrine, nutritional and metabolic diseases
Endocrine, nutritional and metabolic diseases, adrenal gland	Endocrine, nutritional and metabolic diseases
Endocrine, nutritional and metabolic diseases, adrenocortical	Endocrine, nutritional and metabolic diseases
Endocrine, nutritional and metabolic diseases, primary adrenocortical insufficiency	Endocrine, nutritional and metabolic diseases
Endocrine, nutritional and metabolic diseases, addison's disease	Endocrine, nutritional and metabolic diseases
Endocrine, nutritional and metabolic diseases, addisonian crisis	Endocrine, nutritional and metabolic diseases
Endocrine, nutritional and metabolic diseases, adrenocortical insufficiency	Endocrine, nutritional and metabolic diseases
Endocrine, nutritional and metabolic diseases, hypoaldosteronism	Endocrine, nutritional and metabolic diseases
Endocrine, nutritional and metabolic diseases, adrenomedullary	Endocrine, nutritional and metabolic diseases
Endocrine, nutritional and metabolic diseases, ovarian	Endocrine, nutritional and metabolic diseases
Endocrine, nutritional and metabolic diseases, estrogen	Endocrine, nutritional and metabolic diseases
Endocrine, nutritional and metabolic diseases, androgen	Endocrine, nutritional and metabolic diseases
Endocrine, nutritional and metabolic diseases, polycystic ovarian syndrome	Endocrine, nutritional and metabolic diseases
Endocrine, nutritional and metabolic diseases, primary ovarian failure	Endocrine, nutritional and metabolic diseases
Endocrine, nutritional and metabolic diseases, premature menopause	Endocrine, nutritional and metabolic diseases
Endocrine, nutritional and metabolic diseases, testicular	Endocrine, nutritional and metabolic diseases
Endocrine, nutritional and metabolic diseases, testicular hyperfunction	Endocrine, nutritional and metabolic diseases
Endocrine, nutritional and metabolic diseases, testicular hypofunction	Endocrine, nutritional and metabolic diseases
Endocrine, nutritional and metabolic diseases, 5-alpha-reductase deficiency	Endocrine, nutritional and metabolic diseases
Endocrine, nutritional and metabolic diseases, pseudohermaphroditism	Endocrine, nutritional and metabolic diseases
Endocrine, nutritional and metabolic diseases, testicular hypogonadism	Endocrine, nutritional and metabolic diseases
Endocrine, nutritional and metabolic diseases, puberty	Endocrine, nutritional and metabolic diseases
Endocrine, nutritional and metabolic diseases, delayed puberty	Endocrine, nutritional and metabolic diseases
Endocrine, nutritional and metabolic diseases, thelarche	Endocrine, nutritional and metabolic diseases
Endocrine, nutritional and metabolic diseases, polyglandular	Endocrine, nutritional and metabolic diseases
Endocrine, nutritional and metabolic diseases, schmidt's syndrome	Endocrine, nutritional and metabolic diseases
Endocrine, nutritional and metabolic diseases, polyglandular hyperfunction	Endocrine, nutritional and metabolic diseases
Endocrine, nutritional and metabolic diseases, thymus	Endocrine, nutritional and metabolic diseases
Endocrine, nutritional and metabolic diseases, persistent hyperplasia of thymus	Endocrine, nutritional and metabolic diseases
Endocrine, nutritional and metabolic diseases, hypertrophy of thymus	Endocrine, nutritional and metabolic diseases
Endocrine, nutritional and metabolic diseases, abscess of thymus	Endocrine, nutritional and metabolic diseases
Endocrine, nutritional and metabolic diseases, endocrine disorders	Endocrine, nutritional and metabolic diseases
Endocrine, nutritional and metabolic diseases, carcinoid syndrome	Endocrine, nutritional and metabolic diseases
Endocrine, nutritional and metabolic diseases, hypersecretion of intestinal hormones	Endocrine, nutritional and metabolic diseases
Endocrine, nutritional and metabolic diseases, ectopic hormone secretion	Endocrine, nutritional and metabolic diseases
Endocrine, nutritional and metabolic diseases, laron-type	Endocrine, nutritional and metabolic diseases
Endocrine, nutritional and metabolic diseases, psychosocial	Endocrine, nutritional and metabolic diseases
Endocrine, nutritional and metabolic diseases, constitutional tall stature	Endocrine, nutritional and metabolic diseases
Endocrine, nutritional and metabolic diseases, gigantism	Endocrine, nutritional and metabolic diseases
Endocrine, nutritional and metabolic diseases, androgen resistance syndrome	Endocrine, nutritional and metabolic diseases
Endocrine, nutritional and metabolic diseases, reifenstein's syndrome	Endocrine, nutritional and metabolic diseases
Endocrine, nutritional and metabolic diseases, progeria	Endocrine, nutritional and metabolic diseases
Endocrine, nutritional and metabolic diseases, marasmus	Endocrine, nutritional and metabolic diseases
Endocrine, nutritional and metabolic diseases, marasmic	Endocrine, nutritional and metabolic diseases
Endocrine, nutritional and metabolic diseases, protein-energy malnutrition	Endocrine, nutritional and metabolic diseases
Endocrine, nutritional and metabolic diseases, retarded development	Endocrine, nutritional and metabolic diseases
Endocrine, nutritional and metabolic diseases, xerosis	Endocrine, nutritional and metabolic diseases
Endocrine, nutritional and metabolic diseases, bitot's spot	Endocrine, nutritional and metabolic diseases
Endocrine, nutritional and metabolic diseases, corneal ulceration	Endocrine, nutritional and metabolic diseases
Endocrine, nutritional and metabolic diseases, keratomalacia	Endocrine, nutritional and metabolic diseases
Endocrine, nutritional and metabolic diseases, night blindness	Endocrine, nutritional and metabolic diseases
Endocrine, nutritional and metabolic diseases, xerophthalmic	Endocrine, nutritional and metabolic diseases
Endocrine, nutritional and metabolic diseases, cornea	Endocrine, nutritional and metabolic diseases
Endocrine, nutritional and metabolic diseases, xerophthalmia	Endocrine, nutritional and metabolic diseases
Endocrine, nutritional and metabolic diseases, thiamine	Endocrine, nutritional and metabolic diseases
Endocrine, nutritional and metabolic diseases, beriberi	Endocrine, nutritional and metabolic diseases
Endocrine, nutritional and metabolic diseases, wernicke's encephalopathy	Endocrine, nutritional and metabolic diseases
Endocrine, nutritional and metabolic diseases, pellagra	Endocrine, nutritional and metabolic diseases
Endocrine, nutritional and metabolic diseases, ariboflavinosis	Endocrine, nutritional and metabolic diseases
Endocrine, nutritional and metabolic diseases, pyridoxine	Endocrine, nutritional and metabolic diseases
Endocrine, nutritional and metabolic diseases, itamin d deficiency	Endocrine, nutritional and metabolic diseases
Endocrine, nutritional and metabolic diseases, calcium deficiency	Endocrine, nutritional and metabolic diseases
Endocrine, nutritional and metabolic diseases, selenium deficiency	Endocrine, nutritional and metabolic diseases
Endocrine, nutritional and metabolic diseases, zinc deficiency	Endocrine, nutritional and metabolic diseases
Endocrine, nutritional and metabolic diseases, iron deficiency	Endocrine, nutritional and metabolic diseases
Endocrine, nutritional and metabolic diseases, magnesium deficiency	Endocrine, nutritional and metabolic diseases
Endocrine, nutritional and metabolic diseases, manganese deficiency	Endocrine, nutritional and metabolic diseases
Endocrine, nutritional and metabolic diseases, chromium deficiency	Endocrine, nutritional and metabolic diseases
Endocrine, nutritional and metabolic diseases, molybdenum deficiency	Endocrine, nutritional and metabolic diseases
Endocrine, nutritional and metabolic diseases, vanadium deficiency	Endocrine, nutritional and metabolic diseases
Endocrine, nutritional and metabolic diseases, nutritional deficiencies	Endocrine, nutritional and metabolic diseases
Endocrine, nutritional and metabolic diseases, obesity	Endocrine, nutritional and metabolic diseases
Endocrine, nutritional and metabolic diseases, alveolar hypoventilation	Endocrine, nutritional and metabolic diseases
Endocrine, nutritional and metabolic diseases, pickwickian syndrome	Endocrine, nutritional and metabolic diseases
Endocrine, nutritional and metabolic diseases, hyperalimentation	Endocrine, nutritional and metabolic diseases
Endocrine, nutritional and metabolic diseases, hypervitaminosis a	Endocrine, nutritional and metabolic diseases
Endocrine, nutritional and metabolic diseases, hypercarotenaemia	Endocrine, nutritional and metabolic diseases
Endocrine, nutritional and metabolic diseases, megavitamin-b 6 syndrome	Endocrine, nutritional and metabolic diseases
Endocrine, nutritional and metabolic diseases, hypervitaminosis d	Endocrine, nutritional and metabolic diseases
Endocrine, nutritional and metabolic diseases, aphenylketonuria	Endocrine, nutritional and metabolic diseases
Endocrine, nutritional and metabolic diseases, hyperphenylalaninaemias	Endocrine, nutritional and metabolic diseases
Endocrine, nutritional and metabolic diseases, alkaptonuria	Endocrine, nutritional and metabolic diseases
Endocrine, nutritional and metabolic diseases, ochronosis	Endocrine, nutritional and metabolic diseases
Endocrine, nutritional and metabolic diseases, tyrosinaemia	Endocrine, nutritional and metabolic diseases
Endocrine, nutritional and metabolic diseases, albinism	Endocrine, nutritional and metabolic diseases
Endocrine, nutritional and metabolic diseases, oculocutaneous albinism	Endocrine, nutritional and metabolic diseases
Endocrine, nutritional and metabolic diseases, partial albinism	Endocrine, nutritional and metabolic diseases
Endocrine, nutritional and metabolic diseases, albinoidism	Endocrine, nutritional and metabolic diseases
Endocrine, nutritional and metabolic diseases, waardenburg syndrome	Endocrine, nutritional and metabolic diseases
Endocrine, nutritional and metabolic diseases, chÃ©diakâ€“higashi syndrome	Endocrine, nutritional and metabolic diseases
Endocrine, nutritional and metabolic diseases, piebaldism	Endocrine, nutritional and metabolic diseases
Endocrine, nutritional and metabolic diseases, tietz syndrome	Endocrine, nutritional and metabolic diseases
Endocrine, nutritional and metabolic diseases, hermanskyâ€“pudlak syndrome	Endocrine, nutritional and metabolic diseases
Endocrine, nutritional and metabolic diseases, cross syndrome	Endocrine, nutritional and metabolic diseases
Endocrine, nutritional and metabolic diseases, maple-syrup-urine disease	Endocrine, nutritional and metabolic diseases
Endocrine, nutritional and metabolic diseases, propionic acidemia	Endocrine, nutritional and metabolic diseases
Endocrine, nutritional and metabolic diseases, methylmalonic acidemia	Endocrine, nutritional and metabolic diseases
Endocrine, nutritional and metabolic diseases, isovaleric acidemia	Endocrine, nutritional and metabolic diseases
Endocrine, nutritional and metabolic diseases, disorders of fatty-acid metabolism	Endocrine, nutritional and metabolic diseases
Endocrine, nutritional and metabolic diseases, adrenoleukodystrophy	Endocrine, nutritional and metabolic diseases
Endocrine, nutritional and metabolic diseases, muscle carnitine palmityltransferase deficiency	Endocrine, nutritional and metabolic diseases
Endocrine, nutritional and metabolic diseases, cystinuria	Endocrine, nutritional and metabolic diseases
Endocrine, nutritional and metabolic diseases, cystinosis	Endocrine, nutritional and metabolic diseases
Endocrine, nutritional and metabolic diseases, hartnup disease	Endocrine, nutritional and metabolic diseases
Endocrine, nutritional and metabolic diseases, lowe's syndrome	Endocrine, nutritional and metabolic diseases
Endocrine, nutritional and metabolic diseases, sulfur-bearing	Endocrine, nutritional and metabolic diseases
Endocrine, nutritional and metabolic diseases, cystathioninuria	Endocrine, nutritional and metabolic diseases
Endocrine, nutritional and metabolic diseases, homocystinuria	Endocrine, nutritional and metabolic diseases
Endocrine, nutritional and metabolic diseases, methioninaemia	Endocrine, nutritional and metabolic diseases
Endocrine, nutritional and metabolic diseases, sulfite oxidase deficiency	Endocrine, nutritional and metabolic diseases
Endocrine, nutritional and metabolic diseases, argininaemia	Endocrine, nutritional and metabolic diseases
Endocrine, nutritional and metabolic diseases, argininosuccinic aciduria	Endocrine, nutritional and metabolic diseases
Endocrine, nutritional and metabolic diseases, citrullinaemia	Endocrine, nutritional and metabolic diseases
Endocrine, nutritional and metabolic diseases, hyperammonaemia	Endocrine, nutritional and metabolic diseases
Endocrine, nutritional and metabolic diseases, aciduria	Endocrine, nutritional and metabolic diseases
Endocrine, nutritional and metabolic diseases, hydroxylysinaemia	Endocrine, nutritional and metabolic diseases
Endocrine, nutritional and metabolic diseases, hyperlysinaemia	Endocrine, nutritional and metabolic diseases
Endocrine, nutritional and metabolic diseases, lysinuric protein intolerance	Endocrine, nutritional and metabolic diseases
Endocrine, nutritional and metabolic diseases, ornithinaemia	Endocrine, nutritional and metabolic diseases
Endocrine, nutritional and metabolic diseases, hyperhydroxyprolinaemia	Endocrine, nutritional and metabolic diseases
Endocrine, nutritional and metabolic diseases, hyperprolinaemia	Endocrine, nutritional and metabolic diseases
Endocrine, nutritional and metabolic diseases, non-ketotic hyperglycinaemia	Endocrine, nutritional and metabolic diseases
Endocrine, nutritional and metabolic diseases, sarcosinaemia	Endocrine, nutritional and metabolic diseases
Endocrine, nutritional and metabolic diseases, lactose intolerance	Endocrine, nutritional and metabolic diseases
Endocrine, nutritional and metabolic diseases, glycogen storage disease	Endocrine, nutritional and metabolic diseases
Endocrine, nutritional and metabolic diseases, von gierke's disease	Endocrine, nutritional and metabolic diseases
Endocrine, nutritional and metabolic diseases, pompe's disease	Endocrine, nutritional and metabolic diseases
Endocrine, nutritional and metabolic diseases, mcardle's disease	Endocrine, nutritional and metabolic diseases
Endocrine, nutritional and metabolic diseases, fructose	Endocrine, nutritional and metabolic diseases
Endocrine, nutritional and metabolic diseases, essential fructosuria	Endocrine, nutritional and metabolic diseases
Endocrine, nutritional and metabolic diseases, fructose-1	Endocrine, nutritional and metabolic diseases
Endocrine, nutritional and metabolic diseases, 6-diphosphatase deficiency	Endocrine, nutritional and metabolic diseases
Endocrine, nutritional and metabolic diseases, hereditary fructose intolerance	Endocrine, nutritional and metabolic diseases
Endocrine, nutritional and metabolic diseases, galactose	Endocrine, nutritional and metabolic diseases
Endocrine, nutritional and metabolic diseases, galactosaemia	Endocrine, nutritional and metabolic diseases
Endocrine, nutritional and metabolic diseases, galactokinase deficiency	Endocrine, nutritional and metabolic diseases
Endocrine, nutritional and metabolic diseases, glucose-galactose malabsorption	Endocrine, nutritional and metabolic diseases
Endocrine, nutritional and metabolic diseases, sucrase deficiency	Endocrine, nutritional and metabolic diseases
Endocrine, nutritional and metabolic diseases, pyruvate metabolism	Endocrine, nutritional and metabolic diseases
Endocrine, nutritional and metabolic diseases, gluconeogenesis	Endocrine, nutritional and metabolic diseases
Endocrine, nutritional and metabolic diseases, deficiency of phosphoenolpyruvate carboxykinase	Endocrine, nutritional and metabolic diseases
Endocrine, nutritional and metabolic diseases, deficiency of pyruvate carboxylase	Endocrine, nutritional and metabolic diseases
Endocrine, nutritional and metabolic diseases, deficiency of pyruvate dehydrogenase	Endocrine, nutritional and metabolic diseases
Endocrine, nutritional and metabolic diseases, disorders of carbohydrate metabolism	Endocrine, nutritional and metabolic diseases
Endocrine, nutritional and metabolic diseases, essential pentosuria	Endocrine, nutritional and metabolic diseases
Endocrine, nutritional and metabolic diseases, oxalosis	Endocrine, nutritional and metabolic diseases
Endocrine, nutritional and metabolic diseases, oxaluria	Endocrine, nutritional and metabolic diseases
Endocrine, nutritional and metabolic diseases, renal glycosuria	Endocrine, nutritional and metabolic diseases
Endocrine, nutritional and metabolic diseases, sphingolipid	Endocrine, nutritional and metabolic diseases
Endocrine, nutritional and metabolic diseases, gangliosidosis	Endocrine, nutritional and metabolic diseases
Endocrine, nutritional and metabolic diseases, sandhoff disease	Endocrine, nutritional and metabolic diseases
Endocrine, nutritional and metabolic diseases, tay-sachs disease	Endocrine, nutritional and metabolic diseases
Endocrine, nutritional and metabolic diseases, gangliosidosis	Endocrine, nutritional and metabolic diseases
Endocrine, nutritional and metabolic diseases, mucolipidosis iv	Endocrine, nutritional and metabolic diseases
Endocrine, nutritional and metabolic diseases, sphingolipidosis	Endocrine, nutritional and metabolic diseases
Endocrine, nutritional and metabolic diseases, gaucher's disease	Endocrine, nutritional and metabolic diseases
Endocrine, nutritional and metabolic diseases, niemann-pick disease	Endocrine, nutritional and metabolic diseases
Endocrine, nutritional and metabolic diseases, farber's disease	Endocrine, nutritional and metabolic diseases
Endocrine, nutritional and metabolic diseases, fabry's disease	Endocrine, nutritional and metabolic diseases
Endocrine, nutritional and metabolic diseases, neuronal ceroid lipofuscinosis	Endocrine, nutritional and metabolic diseases
Endocrine, nutritional and metabolic diseases, batten disease	Endocrine, nutritional and metabolic diseases
Endocrine, nutritional and metabolic diseases, bielschowsky-jansky disease	Endocrine, nutritional and metabolic diseases
Endocrine, nutritional and metabolic diseases, kufs disease	Endocrine, nutritional and metabolic diseases
Endocrine, nutritional and metabolic diseases, spielmeyer-vogt disease	Endocrine, nutritional and metabolic diseases
Endocrine, nutritional and metabolic diseases, lipid storage disorders	Endocrine, nutritional and metabolic diseases
Endocrine, nutritional and metabolic diseases, cerebrotendinous cholesterosis	Endocrine, nutritional and metabolic diseases
Endocrine, nutritional and metabolic diseases, wolman's disease	Endocrine, nutritional and metabolic diseases
Endocrine, nutritional and metabolic diseases, lipid storage disorder	Endocrine, nutritional and metabolic diseases
Endocrine, nutritional and metabolic diseases, glycosaminoglycan	Endocrine, nutritional and metabolic diseases
Endocrine, nutritional and metabolic diseases, mucopolysaccharidosis	Endocrine, nutritional and metabolic diseases
Endocrine, nutritional and metabolic diseases, hurler syndrome	Endocrine, nutritional and metabolic diseases
Endocrine, nutritional and metabolic diseases, hunter syndrome	Endocrine, nutritional and metabolic diseases
Endocrine, nutritional and metabolic diseases, mucopolysaccharidoses	Endocrine, nutritional and metabolic diseases
Endocrine, nutritional and metabolic diseases, sanfilippo syndrome	Endocrine, nutritional and metabolic diseases
Endocrine, nutritional and metabolic diseases, morquio syndrome	Endocrine, nutritional and metabolic diseases
Endocrine, nutritional and metabolic diseases, mucolipidosis	Endocrine, nutritional and metabolic diseases
Endocrine, nutritional and metabolic diseases, i-cell disease	Endocrine, nutritional and metabolic diseases
Endocrine, nutritional and metabolic diseases, pseudo-hurler polydystrophy	Endocrine, nutritional and metabolic diseases
Endocrine, nutritional and metabolic diseases, aspartylglucosaminuria	Endocrine, nutritional and metabolic diseases
Endocrine, nutritional and metabolic diseases, fucosidosis	Endocrine, nutritional and metabolic diseases
Endocrine, nutritional and metabolic diseases, mannosidosis	Endocrine, nutritional and metabolic diseases
Endocrine, nutritional and metabolic diseases, sialidosis	Endocrine, nutritional and metabolic diseases
Endocrine, nutritional and metabolic diseases, disorders of glycoprotein metabolism	Endocrine, nutritional and metabolic diseases
Endocrine, nutritional and metabolic diseases, disorder of glycoprotein metabolism	Endocrine, nutritional and metabolic diseases
Endocrine, nutritional and metabolic diseases, lipidaemias	Endocrine, nutritional and metabolic diseases
Endocrine, nutritional and metabolic diseases, hypercholesterolaemia	Endocrine, nutritional and metabolic diseases
Endocrine, nutritional and metabolic diseases, hyperbetalipoproteinaemia	Endocrine, nutritional and metabolic diseases
Endocrine, nutritional and metabolic diseases, hyperlipidaemia	Endocrine, nutritional and metabolic diseases
Endocrine, nutritional and metabolic diseases, hyperlipoproteinaemia	Endocrine, nutritional and metabolic diseases
Endocrine, nutritional and metabolic diseases, hyperglyceridaemia	Endocrine, nutritional and metabolic diseases
Endocrine, nutritional and metabolic diseases, hyperprebetalipoproteinaemia	Endocrine, nutritional and metabolic diseases
Endocrine, nutritional and metabolic diseases, betalipoproteinaemia	Endocrine, nutritional and metabolic diseases
Endocrine, nutritional and metabolic diseases, prebetalipoproteinaemia	Endocrine, nutritional and metabolic diseases
Endocrine, nutritional and metabolic diseases, tubero-eruptive xanthoma	Endocrine, nutritional and metabolic diseases
Endocrine, nutritional and metabolic diseases, xanthoma tuberosum	Endocrine, nutritional and metabolic diseases
Endocrine, nutritional and metabolic diseases, hyperchylomicronaemia	Endocrine, nutritional and metabolic diseases
Endocrine, nutritional and metabolic diseases, mixed hyperglyceridaemia	Endocrine, nutritional and metabolic diseases
Endocrine, nutritional and metabolic diseases, familial combined hyperlipidaemia	Endocrine, nutritional and metabolic diseases
Endocrine, nutritional and metabolic diseases, abetalipoproteinaemia	Endocrine, nutritional and metabolic diseases
Endocrine, nutritional and metabolic diseases, high-density lipoprotein deficiency	Endocrine, nutritional and metabolic diseases
Endocrine, nutritional and metabolic diseases, hypoalphalipoproteinaemia	Endocrine, nutritional and metabolic diseases
Endocrine, nutritional and metabolic diseases, hypobetalipoproteinaemia	Endocrine, nutritional and metabolic diseases
Endocrine, nutritional and metabolic diseases, lecithin cholesterol acyltransferase deficiency	Endocrine, nutritional and metabolic diseases
Endocrine, nutritional and metabolic diseases, tangier disease	Endocrine, nutritional and metabolic diseases
Endocrine, nutritional and metabolic diseases, purine	Endocrine, nutritional and metabolic diseases
Endocrine, nutritional and metabolic diseases, pyrimidine	Endocrine, nutritional and metabolic diseases
Endocrine, nutritional and metabolic diseases, hyperuricaemia	Endocrine, nutritional and metabolic diseases
Endocrine, nutritional and metabolic diseases, inflammatory arthritis	Endocrine, nutritional and metabolic diseases
Endocrine, nutritional and metabolic diseases, tophaceous	Endocrine, nutritional and metabolic diseases
Endocrine, nutritional and metabolic diseases, lesch-nyhan syndrome	Endocrine, nutritional and metabolic diseases
Endocrine, nutritional and metabolic diseases, xanthinuria	Endocrine, nutritional and metabolic diseases
Endocrine, nutritional and metabolic diseases, hereditary erythropoietic porphyria	Endocrine, nutritional and metabolic diseases
Endocrine, nutritional and metabolic diseases, erythropoietic protoporphyria	Endocrine, nutritional and metabolic diseases
Endocrine, nutritional and metabolic diseases, erythropoietic porphyria	Endocrine, nutritional and metabolic diseases
Endocrine, nutritional and metabolic diseases, congenital	Endocrine, nutritional and metabolic diseases
Endocrine, nutritional and metabolic diseases, gunther's disease	Endocrine, nutritional and metabolic diseases
Endocrine, nutritional and metabolic diseases, erythropoietic porphyria	Endocrine, nutritional and metabolic diseases
Endocrine, nutritional and metabolic diseases, erythropoietic coproporphyria	Endocrine, nutritional and metabolic diseases
Endocrine, nutritional and metabolic diseases, porphyria cutanea tarda	Endocrine, nutritional and metabolic diseases
Endocrine, nutritional and metabolic diseases, sporadic porphyria cutanea tarda	Endocrine, nutritional and metabolic diseases
Endocrine, nutritional and metabolic diseases, familial porphyria cutanea tarda	Endocrine, nutritional and metabolic diseases
Endocrine, nutritional and metabolic diseases, porphyria	Endocrine, nutritional and metabolic diseases
Endocrine, nutritional and metabolic diseases, acute intermittent porphyria	Endocrine, nutritional and metabolic diseases
Endocrine, nutritional and metabolic diseases, hereditary coproporphyria	Endocrine, nutritional and metabolic diseases
Endocrine, nutritional and metabolic diseases, variegate porphyria	Endocrine, nutritional and metabolic diseases
Endocrine, nutritional and metabolic diseases, chester porphyria	Endocrine, nutritional and metabolic diseases
Endocrine, nutritional and metabolic diseases, porphyria	Endocrine, nutritional and metabolic diseases
Endocrine, nutritional and metabolic diseases, hepatic	Endocrine, nutritional and metabolic diseases
Endocrine, nutritional and metabolic diseases, pseudoporphyria	Endocrine, nutritional and metabolic diseases
Endocrine, nutritional and metabolic diseases, toxic porphyria	Endocrine, nutritional and metabolic diseases
Endocrine, nutritional and metabolic diseases, hepatoerythropoietic porphyria	Endocrine, nutritional and metabolic diseases
Endocrine, nutritional and metabolic diseases, acatalasia	Endocrine, nutritional and metabolic diseases
Endocrine, nutritional and metabolic diseases, gilbert's syndrome	Endocrine, nutritional and metabolic diseases
Endocrine, nutritional and metabolic diseases, crigler-najjar syndrome	Endocrine, nutritional and metabolic diseases
Endocrine, nutritional and metabolic diseases, dubin-johnson syndrome	Endocrine, nutritional and metabolic diseases
Endocrine, nutritional and metabolic diseases, rotor's syndrome	Endocrine, nutritional and metabolic diseases
Endocrine, nutritional and metabolic diseases, mineral	Endocrine, nutritional and metabolic diseases
Endocrine, nutritional and metabolic diseases, copper	Endocrine, nutritional and metabolic diseases
Endocrine, nutritional and metabolic diseases, wilson's disease	Endocrine, nutritional and metabolic diseases
Endocrine, nutritional and metabolic diseases, menkes disease	Endocrine, nutritional and metabolic diseases
Endocrine, nutritional and metabolic diseases, iron metabolism	Endocrine, nutritional and metabolic diseases
Endocrine, nutritional and metabolic diseases, aceruloplasminemia	Endocrine, nutritional and metabolic diseases
Endocrine, nutritional and metabolic diseases, hemochromatosis	Endocrine, nutritional and metabolic diseases
Endocrine, nutritional and metabolic diseases, acrodermatitis enteropathica	Endocrine, nutritional and metabolic diseases
Endocrine, nutritional and metabolic diseases, hypophosphataemia	Endocrine, nutritional and metabolic diseases
Endocrine, nutritional and metabolic diseases, hypophosphatasia	Endocrine, nutritional and metabolic diseases
Endocrine, nutritional and metabolic diseases, osteomalacia	Endocrine, nutritional and metabolic diseases
Endocrine, nutritional and metabolic diseases, hypermagnesemia	Endocrine, nutritional and metabolic diseases
Endocrine, nutritional and metabolic diseases, hypomagnesemia	Endocrine, nutritional and metabolic diseases
Endocrine, nutritional and metabolic diseases, disorders of calcium metabolism	Endocrine, nutritional and metabolic diseases
Endocrine, nutritional and metabolic diseases, hypocalciuric	Endocrine, nutritional and metabolic diseases
Endocrine, nutritional and metabolic diseases, hypercalcaemia	Endocrine, nutritional and metabolic diseases
Endocrine, nutritional and metabolic diseases, hypercalciuria	Endocrine, nutritional and metabolic diseases
Endocrine, nutritional and metabolic diseases, cystic fibrosis	Endocrine, nutritional and metabolic diseases
Endocrine, nutritional and metabolic diseases, amyloidosis	Endocrine, nutritional and metabolic diseases
Endocrine, nutritional and metabolic diseases, familial mediterranean fever	Endocrine, nutritional and metabolic diseases
Endocrine, nutritional and metabolic diseases, hereditary amyloid nephropathy	Endocrine, nutritional and metabolic diseases
Endocrine, nutritional and metabolic diseases, neuropathic heredofamilial amyloidosis	Endocrine, nutritional and metabolic diseases
Endocrine, nutritional and metabolic diseases, amyloid polyneuropathy	Endocrine, nutritional and metabolic diseases
Endocrine, nutritional and metabolic diseases, heredofamilial amyloidosis	Endocrine, nutritional and metabolic diseases
Endocrine, nutritional and metabolic diseases, secondary systemic amyloidosis	Endocrine, nutritional and metabolic diseases
Endocrine, nutritional and metabolic diseases, haemodialysis-associated amyloidosis	Endocrine, nutritional and metabolic diseases
Endocrine, nutritional and metabolic diseases, organ-limited amyloidosis	Endocrine, nutritional and metabolic diseases
Endocrine, nutritional and metabolic diseases, localized amyloidosis	Endocrine, nutritional and metabolic diseases
Endocrine, nutritional and metabolic diseases, hypovolaemia	Endocrine, nutritional and metabolic diseases
Endocrine, nutritional and metabolic diseases, hyperosmolality	Endocrine, nutritional and metabolic diseases
Endocrine, nutritional and metabolic diseases, hypernatraemia	Endocrine, nutritional and metabolic diseases
Endocrine, nutritional and metabolic diseases, hyponatraemia	Endocrine, nutritional and metabolic diseases
Endocrine, nutritional and metabolic diseases, acidosis	Endocrine, nutritional and metabolic diseases
Endocrine, nutritional and metabolic diseases, respiratory acidosis	Endocrine, nutritional and metabolic diseases
Endocrine, nutritional and metabolic diseases, metabolic acidosis	Endocrine, nutritional and metabolic diseases
Endocrine, nutritional and metabolic diseases, lactic acidosis	Endocrine, nutritional and metabolic diseases
Endocrine, nutritional and metabolic diseases, alkalosis	Endocrine, nutritional and metabolic diseases
Endocrine, nutritional and metabolic diseases, mixed disorder of acid-base balance	Endocrine, nutritional and metabolic diseases
Endocrine, nutritional and metabolic diseases, hyperkalaemia	Endocrine, nutritional and metabolic diseases
Endocrine, nutritional and metabolic diseases, hypokalaemia	Endocrine, nutritional and metabolic diseases
Endocrine, nutritional and metabolic diseases, fluid overload	Endocrine, nutritional and metabolic diseases
Endocrine, nutritional and metabolic diseases, electrolyte imbalance	Endocrine, nutritional and metabolic diseases
Endocrine, nutritional and metabolic diseases, hyperchloraemia	Endocrine, nutritional and metabolic diseases
Endocrine, nutritional and metabolic diseases, hypochloraemia	Endocrine, nutritional and metabolic diseases
Endocrine, nutritional and metabolic diseases, metabolic disorders	Endocrine, nutritional and metabolic diseases
Endocrine, nutritional and metabolic diseases, alpha-1-antitrypsin deficiency	Endocrine, nutritional and metabolic diseases
Endocrine, nutritional and metabolic diseases, bisalbuminaemia	Endocrine, nutritional and metabolic diseases
Endocrine, nutritional and metabolic diseases, lipodystrophy	Endocrine, nutritional and metabolic diseases
Endocrine, nutritional and metabolic diseases, lipomatosis	Endocrine, nutritional and metabolic diseases
Endocrine, nutritional and metabolic diseases, launois-bensaude adenolipomatosis	Endocrine, nutritional and metabolic diseases
Endocrine, nutritional and metabolic diseases, trimethylaminuria	Endocrine, nutritional and metabolic diseases
Endocrine, nutritional and metabolic diseases, metabolic disorder	Endocrine, nutritional and metabolic diseases
Endocrine, nutritional and metabolic diseases, hypoinsulinaemia	Endocrine, nutritional and metabolic diseases
Endocrine, nutritional and metabolic diseases, ketoacidosis	Endocrine, nutritional and metabolic diseases
Endocrine, nutritional and metabolic diseases, insulin resistance	Endocrine, nutritional and metabolic diseases
Endocrine, nutritional and metabolic diseases, hypoglycemia	Endocrine, nutritional and metabolic diseases
Endocrine, nutritional and metabolic diseases, zollingerâ€“ellison syndrome	Endocrine, nutritional and metabolic diseases
Endocrine, nutritional and metabolic diseases, hypothalamic	Endocrine, nutritional and metabolic diseases
Endocrine, nutritional and metabolic diseases, pituitary	Endocrine, nutritional and metabolic diseases
Endocrine, nutritional and metabolic diseases, hypothalamus	Endocrine, nutritional and metabolic diseases
Endocrine, nutritional and metabolic diseases, kallmann syndrome	Endocrine, nutritional and metabolic diseases
Endocrine, nutritional and metabolic diseases, crh	Endocrine, nutritional and metabolic diseases
Endocrine, nutritional and metabolic diseases, tertiary adrenal insufficiency	Endocrine, nutritional and metabolic diseases
Endocrine, nutritional and metabolic diseases, vasopressin	Endocrine, nutritional and metabolic diseases
Endocrine, nutritional and metabolic diseases, neurogenic diabetes insipidus	Endocrine, nutritional and metabolic diseases
Endocrine, nutritional and metabolic diseases, hypothalamic hamartoma	Endocrine, nutritional and metabolic diseases
Endocrine, nutritional and metabolic diseases, hyperpituitarism	Endocrine, nutritional and metabolic diseases
Endocrine, nutritional and metabolic diseases, pituitary acth hypersecretion	Endocrine, nutritional and metabolic diseases
Endocrine, nutritional and metabolic diseases, siadh	Endocrine, nutritional and metabolic diseases
Endocrine, nutritional and metabolic diseases, growth hormone deficiency	Endocrine, nutritional and metabolic diseases
Endocrine, nutritional and metabolic diseases, hypoprolactinemia	Endocrine, nutritional and metabolic diseases
Endocrine, nutritional and metabolic diseases, acth deficiency	Endocrine, nutritional and metabolic diseases
Endocrine, nutritional and metabolic diseases, secondary adrenal insufficiency	Endocrine, nutritional and metabolic diseases
Endocrine, nutritional and metabolic diseases, gnrh insensitivity	Endocrine, nutritional and metabolic diseases
Endocrine, nutritional and metabolic diseases, fsh insensitivity	Endocrine, nutritional and metabolic diseases
Endocrine, nutritional and metabolic diseases, lh/hcg insensitivity	Endocrine, nutritional and metabolic diseases
Endocrine, nutritional and metabolic diseases, neurogenic	Endocrine, nutritional and metabolic diseases
Endocrine, nutritional and metabolic diseases, empty sella syndrome	Endocrine, nutritional and metabolic diseases
Endocrine, nutritional and metabolic diseases, pituitary apoplexy	Endocrine, nutritional and metabolic diseases
Endocrine, nutritional and metabolic diseases, lymphocytic hypophysitis	Endocrine, nutritional and metabolic diseases
Endocrine, nutritional and metabolic diseases, iodine deficiency	Endocrine, nutritional and metabolic diseases
Endocrine, nutritional and metabolic diseases, cretinism	Endocrine, nutritional and metabolic diseases
Endocrine, nutritional and metabolic diseases, myxedema	Endocrine, nutritional and metabolic diseases
Endocrine, nutritional and metabolic diseases, myxedema coma	Endocrine, nutritional and metabolic diseases
Endocrine, nutritional and metabolic diseases, euthyroid sick syndrome	Endocrine, nutritional and metabolic diseases
Endocrine, nutritional and metabolic diseases, hyperthyroxinemia	Endocrine, nutritional and metabolic diseases
Endocrine, nutritional and metabolic diseases, thyroid hormone resistance	Endocrine, nutritional and metabolic diseases
Endocrine, nutritional and metabolic diseases, familial dysalbuminemic hyperthyroxinemia	Endocrine, nutritional and metabolic diseases
Endocrine, nutritional and metabolic diseases, hashitoxicosis	Endocrine, nutritional and metabolic diseases
Endocrine, nutritional and metabolic diseases, thyroid storm	Endocrine, nutritional and metabolic diseases
Endocrine, nutritional and metabolic diseases, de quervain's	Endocrine, nutritional and metabolic diseases
Endocrine, nutritional and metabolic diseases, subacute lymphocytic	Endocrine, nutritional and metabolic diseases
Endocrine, nutritional and metabolic diseases, hashimoto's	Endocrine, nutritional and metabolic diseases
Endocrine, nutritional and metabolic diseases, riedel's	Endocrine, nutritional and metabolic diseases
Endocrine, nutritional and metabolic diseases, pseudopseudohypoparathyroidism	Endocrine, nutritional and metabolic diseases
Endocrine, nutritional and metabolic diseases, osteitis fibrosa cystica	Endocrine, nutritional and metabolic diseases
Endocrine, nutritional and metabolic diseases, primary aldosteronism	Endocrine, nutritional and metabolic diseases
Endocrine, nutritional and metabolic diseases, conn syndrome	Endocrine, nutritional and metabolic diseases
Endocrine, nutritional and metabolic diseases, bartter syndrome	Endocrine, nutritional and metabolic diseases
Endocrine, nutritional and metabolic diseases, glucocorticoid remediable aldosteronism	Endocrine, nutritional and metabolic diseases
Endocrine, nutritional and metabolic diseases, ame	Endocrine, nutritional and metabolic diseases
Endocrine, nutritional and metabolic diseases, liddle's syndrome	Endocrine, nutritional and metabolic diseases
Endocrine, nutritional and metabolic diseases, 17Î± cah	Endocrine, nutritional and metabolic diseases
Endocrine, nutritional and metabolic diseases, cortisol	Endocrine, nutritional and metabolic diseases
Endocrine, nutritional and metabolic diseases, adrenal insufficiency	Endocrine, nutritional and metabolic diseases
Endocrine, nutritional and metabolic diseases, polycystic ovary syndrome	Endocrine, nutritional and metabolic diseases
Endocrine, nutritional and metabolic diseases, premature ovarian failure	Endocrine, nutritional and metabolic diseases
Endocrine, nutritional and metabolic diseases, 5Î±-reductase deficiency	Endocrine, nutritional and metabolic diseases
Endocrine, nutritional and metabolic diseases, 17Î²-hydroxysteroid dehydrogenase deficiency	Endocrine, nutritional and metabolic diseases
Endocrine, nutritional and metabolic diseases, aromatase excess syndrome	Endocrine, nutritional and metabolic diseases
Endocrine, nutritional and metabolic diseases, androgen receptor	Endocrine, nutritional and metabolic diseases
Endocrine, nutritional and metabolic diseases, androgen insensitivity syndrome	Endocrine, nutritional and metabolic diseases
Endocrine, nutritional and metabolic diseases, hypogonadism	Endocrine, nutritional and metabolic diseases
Endocrine, nutritional and metabolic diseases, hypergonadism	Endocrine, nutritional and metabolic diseases
Endocrine, nutritional and metabolic diseases, hypoandrogenism	Endocrine, nutritional and metabolic diseases
Endocrine, nutritional and metabolic diseases, hypoestrogenism	Endocrine, nutritional and metabolic diseases
Endocrine, nutritional and metabolic diseases, hyperandrogenism	Endocrine, nutritional and metabolic diseases
Endocrine, nutritional and metabolic diseases, hyperestrogenism	Endocrine, nutritional and metabolic diseases
Endocrine, nutritional and metabolic diseases, postorgasmic illness syndrome	Endocrine, nutritional and metabolic diseases
Endocrine, nutritional and metabolic diseases, dwarfism	Endocrine, nutritional and metabolic diseases
Endocrine, nutritional and metabolic diseases, midget	Endocrine, nutritional and metabolic diseases
Endocrine, nutritional and metabolic diseases, laron syndrome	Endocrine, nutritional and metabolic diseases
Endocrine, nutritional and metabolic diseases, ateliosis	Endocrine, nutritional and metabolic diseases
Endocrine, nutritional and metabolic diseases, autoimmune polyendocrine syndrome multiple	Endocrine, nutritional and metabolic diseases
Endocrine, nutritional and metabolic diseases, aps1	Endocrine, nutritional and metabolic diseases
Endocrine, nutritional and metabolic diseases, aps2	Endocrine, nutritional and metabolic diseases
Endocrine, nutritional and metabolic diseases, multiple endocrine neoplasia	Endocrine, nutritional and metabolic diseases
Endocrine, nutritional and metabolic diseases, 2a	Endocrine, nutritional and metabolic diseases
Endocrine, nutritional and metabolic diseases, 2b	Endocrine, nutritional and metabolic diseases
Endocrine, nutritional and metabolic diseases, werner syndrome	Endocrine, nutritional and metabolic diseases
Endocrine, nutritional and metabolic diseases, acrogeria	Endocrine, nutritional and metabolic diseases
Endocrine, nutritional and metabolic diseases, metageria	Endocrine, nutritional and metabolic diseases
Endocrine, nutritional and metabolic diseases, woodhouseâ€“sakati syndrome	Endocrine, nutritional and metabolic diseases
Endocrine, nutritional and metabolic diseases, vitamin deficiency	Endocrine, nutritional and metabolic diseases
Endocrine, nutritional and metabolic diseases, wernickeâ€“korsakoff syndrome	Endocrine, nutritional and metabolic diseases
Endocrine, nutritional and metabolic diseases, korsakoff's syndrome	Endocrine, nutritional and metabolic diseases
Endocrine, nutritional and metabolic diseases, riboflavin deficiency	Endocrine, nutritional and metabolic diseases
Endocrine, nutritional and metabolic diseases, pyridoxine deficiency	Endocrine, nutritional and metabolic diseases
Endocrine, nutritional and metabolic diseases, biotin deficiency	Endocrine, nutritional and metabolic diseases
Endocrine, nutritional and metabolic diseases, folate deficiency	Endocrine, nutritional and metabolic diseases
Endocrine, nutritional and metabolic diseases, vitamin b12 deficiency	Endocrine, nutritional and metabolic diseases
Endocrine, nutritional and metabolic diseases, vitamin a deficiency	Endocrine, nutritional and metabolic diseases
Endocrine, nutritional and metabolic diseases, bitot's spots	Endocrine, nutritional and metabolic diseases
Endocrine, nutritional and metabolic diseases, vitamin e deficiency	Endocrine, nutritional and metabolic diseases
Endocrine, nutritional and metabolic diseases, mineraldeficiency	Endocrine, nutritional and metabolic diseases
Endocrine, nutritional and metabolic diseases, keshan disease	Endocrine, nutritional and metabolic diseases
Endocrine, nutritional and metabolic diseases, overnutrition	Endocrine, nutritional and metabolic diseases
Endocrine, nutritional and metabolic diseases, overweight	Endocrine, nutritional and metabolic diseases
Endocrine, nutritional and metabolic diseases, vitamin poisoning	Endocrine, nutritional and metabolic diseases
Endocrine, nutritional and metabolic diseases, hypervitaminosis e	Endocrine, nutritional and metabolic diseases
Endocrine, nutritional and metabolic diseases, inborn errors of metal metabolism	Endocrine, nutritional and metabolic diseases
Endocrine, nutritional and metabolic diseases, glutaric acidemia type 1	Endocrine, nutritional and metabolic diseases
Endocrine, nutritional and metabolic diseases, hyperlysinemia	Endocrine, nutritional and metabolic diseases
Endocrine, nutritional and metabolic diseases, pipecolic acidemia	Endocrine, nutritional and metabolic diseases
Endocrine, nutritional and metabolic diseases, saccharopinuria	Endocrine, nutritional and metabolic diseases
Endocrine, nutritional and metabolic diseases, leucine	Endocrine, nutritional and metabolic diseases
Endocrine, nutritional and metabolic diseases, 3-hydroxy-3-methylglutaryl-coa lyase deficiency	Endocrine, nutritional and metabolic diseases
Endocrine, nutritional and metabolic diseases, 3-methylcrotonyl-coa carboxylase deficiency	Endocrine, nutritional and metabolic diseases
Endocrine, nutritional and metabolic diseases, 3-methylglutaconic aciduria 1	Endocrine, nutritional and metabolic diseases
Endocrine, nutritional and metabolic diseases, maple syrup urine disease	Endocrine, nutritional and metabolic diseases
Endocrine, nutritional and metabolic diseases, hypertryptophanemia	Endocrine, nutritional and metabolic diseases
Endocrine, nutritional and metabolic diseases, g	Endocrine, nutritional and metabolic diseases
Endocrine, nutritional and metabolic diseases, pyruvate	Endocrine, nutritional and metabolic diseases
Endocrine, nutritional and metabolic diseases, citrate	Endocrine, nutritional and metabolic diseases
Endocrine, nutritional and metabolic diseases, d-glyceric acidemia	Endocrine, nutritional and metabolic diseases
Endocrine, nutritional and metabolic diseases, glutathione synthetase deficiency	Endocrine, nutritional and metabolic diseases
Endocrine, nutritional and metabolic diseases, sarcosinemia	Endocrine, nutritional and metabolic diseases
Endocrine, nutritional and metabolic diseases, gamt deficiency	Endocrine, nutritional and metabolic diseases
Endocrine, nutritional and metabolic diseases, glycine encephalopathy	Endocrine, nutritional and metabolic diseases
Endocrine, nutritional and metabolic diseases, Î±-ketoglutarate	Endocrine, nutritional and metabolic diseases
Endocrine, nutritional and metabolic diseases, carnosinemia	Endocrine, nutritional and metabolic diseases
Endocrine, nutritional and metabolic diseases, histidinemia	Endocrine, nutritional and metabolic diseases
Endocrine, nutritional and metabolic diseases, urocanic aciduria	Endocrine, nutritional and metabolic diseases
Endocrine, nutritional and metabolic diseases, hyperprolinemia	Endocrine, nutritional and metabolic diseases
Endocrine, nutritional and metabolic diseases, prolidase deficiency	Endocrine, nutritional and metabolic diseases
Endocrine, nutritional and metabolic diseases, hypervalinemia	Endocrine, nutritional and metabolic diseases
Endocrine, nutritional and metabolic diseases, isobutyryl-coa dehydrogenase deficiency	Endocrine, nutritional and metabolic diseases
Endocrine, nutritional and metabolic diseases, isoleucine	Endocrine, nutritional and metabolic diseases
Endocrine, nutritional and metabolic diseases, 2-methylbutyryl-coa dehydrogenase deficiency	Endocrine, nutritional and metabolic diseases
Endocrine, nutritional and metabolic diseases, beta-ketothiolase deficiency	Endocrine, nutritional and metabolic diseases
Endocrine, nutritional and metabolic diseases, hypermethioninemia	Endocrine, nutritional and metabolic diseases
Endocrine, nutritional and metabolic diseases, methylmalonyl-coa mutase deficiency	Endocrine, nutritional and metabolic diseases
Endocrine, nutritional and metabolic diseases, fumarate	Endocrine, nutritional and metabolic diseases
Endocrine, nutritional and metabolic diseases, phenylalanine	Endocrine, nutritional and metabolic diseases
Endocrine, nutritional and metabolic diseases, 6-pyruvoyltetrahydropterin synthase deficiency	Endocrine, nutritional and metabolic diseases
Endocrine, nutritional and metabolic diseases, tetrahydrobiopterin deficiency	Endocrine, nutritional and metabolic diseases
Endocrine, nutritional and metabolic diseases, tyrosinemia	Endocrine, nutritional and metabolic diseases
Endocrine, nutritional and metabolic diseases, hawkinsinuria	Endocrine, nutritional and metabolic diseases
Endocrine, nutritional and metabolic diseases, ocular albinism	Endocrine, nutritional and metabolic diseases
Endocrine, nutritional and metabolic diseases, norepinephrine	Endocrine, nutritional and metabolic diseases
Endocrine, nutritional and metabolic diseases, dopamine beta hydroxylase deficiency	Endocrine, nutritional and metabolic diseases
Endocrine, nutritional and metabolic diseases, brunner syndrome	Endocrine, nutritional and metabolic diseases
Endocrine, nutritional and metabolic diseases, hyperammonemia	Endocrine, nutritional and metabolic diseases
Endocrine, nutritional and metabolic diseases, argininemia	Endocrine, nutritional and metabolic diseases
Endocrine, nutritional and metabolic diseases, carbamoyl phosphate synthetase i deficiency	Endocrine, nutritional and metabolic diseases
Endocrine, nutritional and metabolic diseases, citrullinemia	Endocrine, nutritional and metabolic diseases
Endocrine, nutritional and metabolic diseases, n-acetylglutamate synthase deficiency	Endocrine, nutritional and metabolic diseases
Endocrine, nutritional and metabolic diseases, ornithine transcarbamylase deficiency	Endocrine, nutritional and metabolic diseases
Endocrine, nutritional and metabolic diseases, translocase deficiency	Endocrine, nutritional and metabolic diseases
Endocrine, nutritional and metabolic diseases, iminoglycinuria	Endocrine, nutritional and metabolic diseases
Endocrine, nutritional and metabolic diseases, fanconi syndrome	Endocrine, nutritional and metabolic diseases
Endocrine, nutritional and metabolic diseases, oculocerebrorenal syndrome	Endocrine, nutritional and metabolic diseases
Endocrine, nutritional and metabolic diseases, 2-hydroxyglutaric aciduria	Endocrine, nutritional and metabolic diseases
Endocrine, nutritional and metabolic diseases, aminoacylase 1 deficiency	Endocrine, nutritional and metabolic diseases
Endocrine, nutritional and metabolic diseases, ethylmalonic encephalopathy	Endocrine, nutritional and metabolic diseases
Endocrine, nutritional and metabolic diseases, fumarase deficiency	Endocrine, nutritional and metabolic diseases
Endocrine, nutritional and metabolic diseases, fatty-acid metabolism disorders	Endocrine, nutritional and metabolic diseases
Endocrine, nutritional and metabolic diseases, biotinidase deficiency	Endocrine, nutritional and metabolic diseases
Endocrine, nutritional and metabolic diseases, mitochondrial trifunctional protein deficiency	Endocrine, nutritional and metabolic diseases
Endocrine, nutritional and metabolic diseases, acute fatty liver of pregnancy	Endocrine, nutritional and metabolic diseases
Endocrine, nutritional and metabolic diseases, unsaturated	Endocrine, nutritional and metabolic diseases
Endocrine, nutritional and metabolic diseases, 2	Endocrine, nutritional and metabolic diseases
Endocrine, nutritional and metabolic diseases, 4 dienoyl-coa reductase deficiency	Endocrine, nutritional and metabolic diseases
Endocrine, nutritional and metabolic diseases, odd chain	Endocrine, nutritional and metabolic diseases
Endocrine, nutritional and metabolic diseases, 3-hydroxyacyl-coenzyme a dehydrogenase deficiency	Endocrine, nutritional and metabolic diseases
Endocrine, nutritional and metabolic diseases, glutaric acidemia type 2	Endocrine, nutritional and metabolic diseases
Endocrine, nutritional and metabolic diseases, malonic aciduria	Endocrine, nutritional and metabolic diseases
Endocrine, nutritional and metabolic diseases, sjÃ¶grenâ€“larsson syndrome	Endocrine, nutritional and metabolic diseases
Endocrine, nutritional and metabolic diseases, monosaccharide	Endocrine, nutritional and metabolic diseases
Endocrine, nutritional and metabolic diseases, e73â€“e74	Endocrine, nutritional and metabolic diseases
Endocrine, nutritional and metabolic diseases, 271	Endocrine, nutritional and metabolic diseases
Endocrine, nutritional and metabolic diseases, sucrose	Endocrine, nutritional and metabolic diseases
Endocrine, nutritional and metabolic diseases, disaccharide	Endocrine, nutritional and metabolic diseases
Endocrine, nutritional and metabolic diseases, congenital alactasia	Endocrine, nutritional and metabolic diseases
Endocrine, nutritional and metabolic diseases, sucrose intolerance	Endocrine, nutritional and metabolic diseases
Endocrine, nutritional and metabolic diseases, inborn errors of renal tubular transport	Endocrine, nutritional and metabolic diseases
Endocrine, nutritional and metabolic diseases, fructose malabsorption	Endocrine, nutritional and metabolic diseases
Endocrine, nutritional and metabolic diseases, fructose intolerance	Endocrine, nutritional and metabolic diseases
Endocrine, nutritional and metabolic diseases, galactosemia	Endocrine, nutritional and metabolic diseases
Endocrine, nutritional and metabolic diseases, galk deficiency	Endocrine, nutritional and metabolic diseases
Endocrine, nutritional and metabolic diseases, galt deficiency	Endocrine, nutritional and metabolic diseases
Endocrine, nutritional and metabolic diseases, gale deficiency	Endocrine, nutritional and metabolic diseases
Endocrine, nutritional and metabolic diseases, adult polyglucosan body disease	Endocrine, nutritional and metabolic diseases
Endocrine, nutritional and metabolic diseases, glycogenolysis	Endocrine, nutritional and metabolic diseases
Endocrine, nutritional and metabolic diseases, gsd type	Endocrine, nutritional and metabolic diseases
Endocrine, nutritional and metabolic diseases, triosephosphate isomerase deficiency	Endocrine, nutritional and metabolic diseases
Endocrine, nutritional and metabolic diseases, pyruvate kinase deficiency	Endocrine, nutritional and metabolic diseases
Endocrine, nutritional and metabolic diseases, fructose bisphosphatase deficiency	Endocrine, nutritional and metabolic diseases
Endocrine, nutritional and metabolic diseases, glucose-6-phosphate dehydrogenase deficiency	Endocrine, nutritional and metabolic diseases
Endocrine, nutritional and metabolic diseases, transaldolase deficiency	Endocrine, nutritional and metabolic diseases
Endocrine, nutritional and metabolic diseases, 6-phosphogluconate dehydrogenase deficiency	Endocrine, nutritional and metabolic diseases
Endocrine, nutritional and metabolic diseases, hyperoxaluria	Endocrine, nutritional and metabolic diseases
Endocrine, nutritional and metabolic diseases, primary hyperoxaluria	Endocrine, nutritional and metabolic diseases
Endocrine, nutritional and metabolic diseases, pentosuria	Endocrine, nutritional and metabolic diseases
Endocrine, nutritional and metabolic diseases, aldolase a deficiency	Endocrine, nutritional and metabolic diseases
Endocrine, nutritional and metabolic diseases, lysosomal storage diseases	Endocrine, nutritional and metabolic diseases
Endocrine, nutritional and metabolic diseases, tayâ€“sachs disease	Endocrine, nutritional and metabolic diseases
Endocrine, nutritional and metabolic diseases, globoside	Endocrine, nutritional and metabolic diseases
Endocrine, nutritional and metabolic diseases, globotriaosylceramide	Endocrine, nutritional and metabolic diseases
Endocrine, nutritional and metabolic diseases, sphingomyelin	Endocrine, nutritional and metabolic diseases
Endocrine, nutritional and metabolic diseases, niemannâ€“pick disease	Endocrine, nutritional and metabolic diseases
Endocrine, nutritional and metabolic diseases, smpd1-associated	Endocrine, nutritional and metabolic diseases
Endocrine, nutritional and metabolic diseases, sulfatidoses	Endocrine, nutritional and metabolic diseases
Endocrine, nutritional and metabolic diseases, leukodystrophy	Endocrine, nutritional and metabolic diseases
Endocrine, nutritional and metabolic diseases, metachromatic leukodystrophy	Endocrine, nutritional and metabolic diseases
Endocrine, nutritional and metabolic diseases, multiple sulfatase deficiency	Endocrine, nutritional and metabolic diseases
Endocrine, nutritional and metabolic diseases, galactocerebroside	Endocrine, nutritional and metabolic diseases
Endocrine, nutritional and metabolic diseases, krabbe disease	Endocrine, nutritional and metabolic diseases
Endocrine, nutritional and metabolic diseases, sphingosine	Endocrine, nutritional and metabolic diseases
Endocrine, nutritional and metabolic diseases, farber disease	Endocrine, nutritional and metabolic diseases
Endocrine, nutritional and metabolic diseases, ncl	Endocrine, nutritional and metabolic diseases
Endocrine, nutritional and metabolic diseases, infantile	Endocrine, nutritional and metabolic diseases
Endocrine, nutritional and metabolic diseases, janskyâ€“bielschowsky disease	Endocrine, nutritional and metabolic diseases
Endocrine, nutritional and metabolic diseases, cerebrotendineous xanthomatosis	Endocrine, nutritional and metabolic diseases
Endocrine, nutritional and metabolic diseases, cholesteryl ester storage disease	Endocrine, nutritional and metabolic diseases
Endocrine, nutritional and metabolic diseases, lysosomal acid lipase deficiency	Endocrine, nutritional and metabolic diseases
Endocrine, nutritional and metabolic diseases, wolman disease	Endocrine, nutritional and metabolic diseases
Endocrine, nutritional and metabolic diseases, sea-blue histiocytosis	Endocrine, nutritional and metabolic diseases
Endocrine, nutritional and metabolic diseases, hurler-scheie syndrome	Endocrine, nutritional and metabolic diseases
Endocrine, nutritional and metabolic diseases, scheie syndrome	Endocrine, nutritional and metabolic diseases
Endocrine, nutritional and metabolic diseases, hunter syndrome	Endocrine, nutritional and metabolic diseases
Endocrine, nutritional and metabolic diseases, sanfilippo syndrome	Endocrine, nutritional and metabolic diseases
Endocrine, nutritional and metabolic diseases, morquio syndrome	Endocrine, nutritional and metabolic diseases
Endocrine, nutritional and metabolic diseases, maroteaux-lamy syndrome	Endocrine, nutritional and metabolic diseases
Endocrine, nutritional and metabolic diseases, sly syndrome	Endocrine, nutritional and metabolic diseases
Endocrine, nutritional and metabolic diseases, hyaluronidase deficiency	Endocrine, nutritional and metabolic diseases
Endocrine, nutritional and metabolic diseases, glycoproteinoses	Endocrine, nutritional and metabolic diseases
Endocrine, nutritional and metabolic diseases, dolichol kinase deficiency	Endocrine, nutritional and metabolic diseases
Endocrine, nutritional and metabolic diseases, congenital disorder of glycosylation	Endocrine, nutritional and metabolic diseases
Endocrine, nutritional and metabolic diseases, mucolipidosis	Endocrine, nutritional and metabolic diseases
Endocrine, nutritional and metabolic diseases, i-cell disease (ml ii),pseudo-hurler polydystrophy (ml iii),alpha-mannosidosis	Endocrine, nutritional and metabolic diseases
Endocrine, nutritional and metabolic diseases, beta-mannosidosis	Endocrine, nutritional and metabolic diseases
Endocrine, nutritional and metabolic diseases, schindler disease	Endocrine, nutritional and metabolic diseases
Endocrine, nutritional and metabolic diseases, salla disease	Endocrine, nutritional and metabolic diseases
Endocrine, nutritional and metabolic diseases, galactosialidosis	Endocrine, nutritional and metabolic diseases
Endocrine, nutritional and metabolic diseases, dyslipidemia	Endocrine, nutritional and metabolic diseases
Endocrine, nutritional and metabolic diseases, hyperlipidemia	Endocrine, nutritional and metabolic diseases
Endocrine, nutritional and metabolic diseases, hypercholesterolemia	Endocrine, nutritional and metabolic diseases
Endocrine, nutritional and metabolic diseases, hypertriglyceridemia	Endocrine, nutritional and metabolic diseases
Endocrine, nutritional and metabolic diseases, lipoprotein lipase deficiency	Endocrine, nutritional and metabolic diseases
Endocrine, nutritional and metabolic diseases, familial apoprotein cii deficiency	Endocrine, nutritional and metabolic diseases
Endocrine, nutritional and metabolic diseases, hypercholesterolemia	Endocrine, nutritional and metabolic diseases
Endocrine, nutritional and metabolic diseases, combined hyperlipidemia	Endocrine, nutritional and metabolic diseases
Endocrine, nutritional and metabolic diseases, familial dysbetalipoproteinemia	Endocrine, nutritional and metabolic diseases
Endocrine, nutritional and metabolic diseases, familial hypertriglyceridemia	Endocrine, nutritional and metabolic diseases
Endocrine, nutritional and metabolic diseases, xanthoma/xanthomatosis	Endocrine, nutritional and metabolic diseases
Endocrine, nutritional and metabolic diseases, hypolipoproteinemia	Endocrine, nutritional and metabolic diseases
Endocrine, nutritional and metabolic diseases, hypoalphalipoproteinemia/hdl	Endocrine, nutritional and metabolic diseases
Endocrine, nutritional and metabolic diseases, hypobetalipoproteinemia/ldl	Endocrine, nutritional and metabolic diseases
Endocrine, nutritional and metabolic diseases, abetalipoproteinemia	Endocrine, nutritional and metabolic diseases
Endocrine, nutritional and metabolic diseases, apolipoprotein b deficiency	Endocrine, nutritional and metabolic diseases
Endocrine, nutritional and metabolic diseases, chylomicron retention disease	Endocrine, nutritional and metabolic diseases
Endocrine, nutritional and metabolic diseases, barraquerâ€“simons syndrome	Endocrine, nutritional and metabolic diseases
Endocrine, nutritional and metabolic diseases, adiposis dolorosa	Endocrine, nutritional and metabolic diseases
Endocrine, nutritional and metabolic diseases, lipoid proteinosis	Endocrine, nutritional and metabolic diseases
Endocrine, nutritional and metabolic diseases, apoa1 familial renal amyloidosis	Endocrine, nutritional and metabolic diseases
Endocrine, nutritional and metabolic diseases, purineâ€“pyrimidine metabolism	Endocrine, nutritional and metabolic diseases
Endocrine, nutritional and metabolic diseases, 277.2	Endocrine, nutritional and metabolic diseases
Endocrine, nutritional and metabolic diseases, purine metabolism	Endocrine, nutritional and metabolic diseases
Endocrine, nutritional and metabolic diseases, adenylosuccinate lyase deficiency	Endocrine, nutritional and metabolic diseases
Endocrine, nutritional and metabolic diseases, adenosine monophosphate deaminase deficiency type 1	Endocrine, nutritional and metabolic diseases
Endocrine, nutritional and metabolic diseases, leschâ€“nyhan syndrome	Endocrine, nutritional and metabolic diseases
Endocrine, nutritional and metabolic diseases, hyperuricemia	Endocrine, nutritional and metabolic diseases
Endocrine, nutritional and metabolic diseases, adenine phosphoribosyltransferase deficiency	Endocrine, nutritional and metabolic diseases
Endocrine, nutritional and metabolic diseases, adenosine deaminase deficiency	Endocrine, nutritional and metabolic diseases
Endocrine, nutritional and metabolic diseases, purine nucleoside phosphorylase deficiency	Endocrine, nutritional and metabolic diseases
Endocrine, nutritional and metabolic diseases, mitochondrial neurogastrointestinal encephalopathy syndrome	Endocrine, nutritional and metabolic diseases
Endocrine, nutritional and metabolic diseases, pyrimidine metabolism	Endocrine, nutritional and metabolic diseases
Endocrine, nutritional and metabolic diseases, orotic aciduria	Endocrine, nutritional and metabolic diseases
Endocrine, nutritional and metabolic diseases, miller syndrome	Endocrine, nutritional and metabolic diseases
Endocrine, nutritional and metabolic diseases, dihydropyrimidine dehydrogenase deficiency	Endocrine, nutritional and metabolic diseases
Endocrine, nutritional and metabolic diseases, alad porphyria	Endocrine, nutritional and metabolic diseases
Endocrine, nutritional and metabolic diseases, gunther disease/congenital erythropoietic porphyria	Endocrine, nutritional and metabolic diseases
Endocrine, nutritional and metabolic diseases, harderoporphyria	Endocrine, nutritional and metabolic diseases
Endocrine, nutritional and metabolic diseases, hereditary hyperbilirubinemia	Endocrine, nutritional and metabolic diseases
Endocrine, nutritional and metabolic diseases, bilirubin	Endocrine, nutritional and metabolic diseases
Endocrine, nutritional and metabolic diseases, criglerâ€“najjar syndrome	Endocrine, nutritional and metabolic diseases
Endocrine, nutritional and metabolic diseases, luceyâ€“driscoll syndrome	Endocrine, nutritional and metabolic diseases
Endocrine, nutritional and metabolic diseases, dubinâ€“johnson syndrome	Endocrine, nutritional and metabolic diseases
Endocrine, nutritional and metabolic diseases, rotor syndrome	Endocrine, nutritional and metabolic diseases
Endocrine, nutritional and metabolic diseases, genetic disorder	Endocrine, nutritional and metabolic diseases
Endocrine, nutritional and metabolic diseases, peroxisomal disorders	Endocrine, nutritional and metabolic diseases
Endocrine, nutritional and metabolic diseases, peroxisome biogenesis disorder	Endocrine, nutritional and metabolic diseases
Endocrine, nutritional and metabolic diseases, zellweger syndrome	Endocrine, nutritional and metabolic diseases
Endocrine, nutritional and metabolic diseases, neonatal adrenoleukodystrophy	Endocrine, nutritional and metabolic diseases
Endocrine, nutritional and metabolic diseases, infantile refsum disease	Endocrine, nutritional and metabolic diseases
Endocrine, nutritional and metabolic diseases, adult refsum disease-2	Endocrine, nutritional and metabolic diseases
Endocrine, nutritional and metabolic diseases, rcp 1	Endocrine, nutritional and metabolic diseases
Endocrine, nutritional and metabolic diseases, rcp 2&3	Endocrine, nutritional and metabolic diseases
Endocrine, nutritional and metabolic diseases, mevalonate kinase deficiency	Endocrine, nutritional and metabolic diseases
Endocrine, nutritional and metabolic diseases, d-bifunctional protein deficiency	Endocrine, nutritional and metabolic diseases
Endocrine, nutritional and metabolic diseases, adult refsum disease-1	Endocrine, nutritional and metabolic diseases
Endocrine, nutritional and metabolic diseases, x-linked adrenoleukodystrophy	Endocrine, nutritional and metabolic diseases
Endocrine, nutritional and metabolic diseases, danon disease	Endocrine, nutritional and metabolic diseases
Endocrine, nutritional and metabolic diseases, primary iron overload disorder	Endocrine, nutritional and metabolic diseases
Endocrine, nutritional and metabolic diseases, hemochromatosis/hfe1	Endocrine, nutritional and metabolic diseases
Endocrine, nutritional and metabolic diseases, iron overload/hfe4	Endocrine, nutritional and metabolic diseases
Endocrine, nutritional and metabolic diseases, atransferrinemia	Endocrine, nutritional and metabolic diseases
Endocrine, nutritional and metabolic diseases, hemosiderosis	Endocrine, nutritional and metabolic diseases
Endocrine, nutritional and metabolic diseases, cu	Endocrine, nutritional and metabolic diseases
Endocrine, nutritional and metabolic diseases, copper toxicity	Endocrine, nutritional and metabolic diseases
Endocrine, nutritional and metabolic diseases, copper deficiency	Endocrine, nutritional and metabolic diseases
Endocrine, nutritional and metabolic diseases, occipital horn syndrome	Endocrine, nutritional and metabolic diseases
Endocrine, nutritional and metabolic diseases, zinc toxicity	Endocrine, nutritional and metabolic diseases
Endocrine, nutritional and metabolic diseases, template:water-electrolyte imbalance and acid-base imbalance	Endocrine, nutritional and metabolic diseases
Endocrine, nutritional and metabolic diseases, hyperphosphatemia	Endocrine, nutritional and metabolic diseases
Endocrine, nutritional and metabolic diseases, hypophosphatemia	Endocrine, nutritional and metabolic diseases
Endocrine, nutritional and metabolic diseases, alkaline phosphatase	Endocrine, nutritional and metabolic diseases
Endocrine, nutritional and metabolic diseases, milk-alkali syndrome	Endocrine, nutritional and metabolic diseases
Endocrine, nutritional and metabolic diseases, calcinosis	Endocrine, nutritional and metabolic diseases
Endocrine, nutritional and metabolic diseases, calciphylaxis	Endocrine, nutritional and metabolic diseases
Endocrine, nutritional and metabolic diseases, calcinosis cutis	Endocrine, nutritional and metabolic diseases
Endocrine, nutritional and metabolic diseases, calcification	Endocrine, nutritional and metabolic diseases
Endocrine, nutritional and metabolic diseases, metastatic calcification	Endocrine, nutritional and metabolic diseases
Endocrine, nutritional and metabolic diseases, dystrophic calcification	Endocrine, nutritional and metabolic diseases
Endocrine, nutritional and metabolic diseases, familial hypocalciuric hypercalcemia	Endocrine, nutritional and metabolic diseases
Endocrine, nutritional and metabolic diseases, hypocalcaemia	Endocrine, nutritional and metabolic diseases
Endocrine, nutritional and metabolic diseases, albright's hereditary osteodystrophy	Endocrine, nutritional and metabolic diseases
Endocrine, nutritional and metabolic diseases, al amyloidosis	Endocrine, nutritional and metabolic diseases
Endocrine, nutritional and metabolic diseases, aa amyloidosis	Endocrine, nutritional and metabolic diseases
Endocrine, nutritional and metabolic diseases, aÎ²2m/haemodialysis-associated	Endocrine, nutritional and metabolic diseases
Endocrine, nutritional and metabolic diseases, agel/finnish type	Endocrine, nutritional and metabolic diseases
Endocrine, nutritional and metabolic diseases, aa/familial mediterranean fever	Endocrine, nutritional and metabolic diseases
Endocrine, nutritional and metabolic diseases, attr/transthyretin-related hereditary	Endocrine, nutritional and metabolic diseases
Endocrine, nutritional and metabolic diseases, aanf/isolated atrial	Endocrine, nutritional and metabolic diseases
Endocrine, nutritional and metabolic diseases, familial amyloid neuropathy	Endocrine, nutritional and metabolic diseases
Endocrine, nutritional and metabolic diseases, acys+abri/cerebral amyloid angiopathy	Endocrine, nutritional and metabolic diseases
Endocrine, nutritional and metabolic diseases, amyloidosis	Endocrine, nutritional and metabolic diseases
Endocrine, nutritional and metabolic diseases, amyloid purpura	Endocrine, nutritional and metabolic diseases
Endocrine, nutritional and metabolic diseases, acal/medullary thyroid cancer	Endocrine, nutritional and metabolic diseases
Endocrine, nutritional and metabolic diseases, apro/prolactinoma	Endocrine, nutritional and metabolic diseases
Endocrine, nutritional and metabolic diseases, aiapp/insulinoma	Endocrine, nutritional and metabolic diseases
Endocrine, nutritional and metabolic diseases, aiapp/diabetes mellitus type 2	Endocrine, nutritional and metabolic diseases
Endocrine, nutritional and metabolic diseases, acidâ€“base imbalance	Endocrine, nutritional and metabolic diseases
Endocrine, nutritional and metabolic diseases, hypovolemia	Endocrine, nutritional and metabolic diseases
Endocrine, nutritional and metabolic diseases, hypervolemia	Endocrine, nutritional and metabolic diseases
Endocrine, nutritional and metabolic diseases, hypernatremia	Endocrine, nutritional and metabolic diseases
Endocrine, nutritional and metabolic diseases, salt poisoning	Endocrine, nutritional and metabolic diseases
Endocrine, nutritional and metabolic diseases, alcoholic ketoacidosis	Endocrine, nutritional and metabolic diseases
Endocrine, nutritional and metabolic diseases, hyperchloremic	Endocrine, nutritional and metabolic diseases
Endocrine, nutritional and metabolic diseases, renal tubular	Endocrine, nutritional and metabolic diseases
Endocrine, nutritional and metabolic diseases, respiratory	Endocrine, nutritional and metabolic diseases
Endocrine, nutritional and metabolic diseases, contraction alkalosis	Endocrine, nutritional and metabolic diseases
Genitourinary system, urinary tract infections	Genitourinary system
Genitourinary system, prostate hyperplasia	Genitourinary system
Genitourinary system, vaginal bleeding	Genitourinary system
Genitourinary system, glomerular abnormality	Genitourinary system
Genitourinary system, focal and segmental glomerular lesions	Genitourinary system
Genitourinary system, membranous glomerulonephritis	Genitourinary system
Genitourinary system, mesangial proliferative glomerulonephritis	Genitourinary system
Genitourinary system, endocapillary proliferative glomerulonephritis	Genitourinary system
Genitourinary system, mesangiocapillary glomerulonephritis	Genitourinary system
Genitourinary system, membranoproliferative glomerulonephritis	Genitourinary system
Genitourinary system, dense deposit disease	Genitourinary system
Genitourinary system, crescentic glomerulonephritis	Genitourinary system
Genitourinary system, extracapillary glomerulonephritis	Genitourinary system
Genitourinary system, proliferative glomerulonephritis	Genitourinary system
Genitourinary system, acute nephritic syndrome	Genitourinary system
Genitourinary system, nephritic syndrome	Genitourinary system
Genitourinary system, haematuria	Genitourinary system
Genitourinary system, chronic nephritic syndrome	Genitourinary system
Genitourinary system, nephrotic syndrome	Genitourinary system
Genitourinary system, lipoid nephrosis	Genitourinary system
Genitourinary system, isolated proteinuria	Genitourinary system
Genitourinary system, hereditary nephropathy	Genitourinary system
Genitourinary system, glomerular	Genitourinary system
Genitourinary system, acute	Genitourinary system
Genitourinary system, tubulo-interstitial nephritis	Genitourinary system
Genitourinary system, pyelonephritis	Genitourinary system
Genitourinary system, chronic	Genitourinary system
Genitourinary system, nonobstructive reflux-associated chronic pyelonephritis	Genitourinary system
Genitourinary system, chronic obstructive pyelonephritis	Genitourinary system
Genitourinary system, interstitial nephritis	Genitourinary system
Genitourinary system, pyelitis	Genitourinary system
Genitourinary system, hydronephrosis	Genitourinary system
Genitourinary system, ureteropelvic	Genitourinary system
Genitourinary system, ureteral	Genitourinary system
Genitourinary system, stricture	Genitourinary system
Genitourinary system, renal	Genitourinary system
Genitourinary system, calculous	Genitourinary system
Genitourinary system, hydroureter	Genitourinary system
Genitourinary system, kinking	Genitourinary system
Genitourinary system, ureter	Genitourinary system
Genitourinary system, pyonephrosis	Genitourinary system
Genitourinary system, vesicoureteral-reflux-associated uropathy	Genitourinary system
Genitourinary system, reflux uropathy	Genitourinary system
Genitourinary system, balkan nephropathy	Genitourinary system
Genitourinary system, balkan endemic nephropathy	Genitourinary system
Genitourinary system, perinephric abscess	Genitourinary system
Genitourinary system, renal tubulo-interstitial diseases	Genitourinary system
Genitourinary system, renal tubulo-interstitial disease	Genitourinary system
Genitourinary system, infection of kidney	Genitourinary system
Genitourinary system, acute renal failure	Genitourinary system
Genitourinary system, tubular necrosis	Genitourinary system
Genitourinary system, acute cortical necrosis	Genitourinary system
Genitourinary system, medullary necrosis	Genitourinary system
Genitourinary system, chronic renal failure	Genitourinary system
Genitourinary system, renal failure	Genitourinary system
Genitourinary system, calculus	Genitourinary system
Genitourinary system, kidney	Genitourinary system
Genitourinary system, nephrolithiasis	Genitourinary system
Genitourinary system, urinary calculus	Genitourinary system
Genitourinary system, renal osteodystrophy	Genitourinary system
Genitourinary system, azotaemic osteodystrophy	Genitourinary system
Genitourinary system, phosphate-losing tubular disorders	Genitourinary system
Genitourinary system, nephrogenic diabetes insipidus	Genitourinary system
Genitourinary system, lightwood-albright syndrome	Genitourinary system
Genitourinary system, renal tubular acidosis	Genitourinary system
Genitourinary system, secondary hyperparathyroidism	Genitourinary system
Genitourinary system, contracted kidney	Genitourinary system
Genitourinary system, small kidney	Genitourinary system
Genitourinary system, ischaemia	Genitourinary system
Genitourinary system, infarction	Genitourinary system
Genitourinary system, hypertrophy of kidney	Genitourinary system
Genitourinary system, megaloureter	Genitourinary system
Genitourinary system, nephroptosis	Genitourinary system
Genitourinary system, pyeloureteritis	Genitourinary system
Genitourinary system, ureteritis	Genitourinary system
Genitourinary system, ureterocele	Genitourinary system
Genitourinary system, cystitis	Genitourinary system
Genitourinary system, acute cystitis	Genitourinary system
Genitourinary system, interstitial cystitis	Genitourinary system
Genitourinary system, chronic cystitis	Genitourinary system
Genitourinary system, trigonitis	Genitourinary system
Genitourinary system, irradiation cystitis	Genitourinary system
Genitourinary system, neuromuscular dysfunction of bladder	Genitourinary system
Genitourinary system, uninhibited neuropathic bladder	Genitourinary system
Genitourinary system, reflex neuropathic bladder	Genitourinary system
Genitourinary system, flaccid neuropathic bladder	Genitourinary system
Genitourinary system, neurogenic bladder	Genitourinary system
Genitourinary system, bladder-neck obstruction	Genitourinary system
Genitourinary system, vesicointestinal fistula	Genitourinary system
Genitourinary system, vesical fistula	Genitourinary system
Genitourinary system, rupture of bladder	Genitourinary system
Genitourinary system, bladder disorder	Genitourinary system
Genitourinary system, urethritis	Genitourinary system
Genitourinary system, urethral syndrome	Genitourinary system
Genitourinary system, urethral abscess	Genitourinary system
Genitourinary system, nongonococcal urethritis	Genitourinary system
Genitourinary system, urethral stricture	Genitourinary system
Genitourinary system, urethral fistula	Genitourinary system
Genitourinary system, urethral diverticulum	Genitourinary system
Genitourinary system, urethral caruncle	Genitourinary system
Genitourinary system, prolapsed urethral mucosa	Genitourinary system
Genitourinary system, other specified disorders of urethra	Genitourinary system
Genitourinary system, urethral disorder	Genitourinary system
Genitourinary system, urinary tract infection	Genitourinary system
Genitourinary system, proteinuria	Genitourinary system
Genitourinary system, orthostatic proteinuria	Genitourinary system
Genitourinary system, stress incontinence	Genitourinary system
Genitourinary system, urinary incontinence	Genitourinary system
Genitourinary system, overflow incontinence	Genitourinary system
Genitourinary system, reflex incontinence	Genitourinary system
Genitourinary system, urge incontinence	Genitourinary system
Genitourinary system, hyperplasia	Genitourinary system
Genitourinary system, prostate	Genitourinary system
Genitourinary system, inflammatory diseases of prostate	Genitourinary system
Genitourinary system, hydrocele	Genitourinary system
Genitourinary system, spermatocele	Genitourinary system
Genitourinary system, encysted hydrocele	Genitourinary system
Genitourinary system, infected hydrocele	Genitourinary system
Genitourinary system, torsion of testis	Genitourinary system
Genitourinary system, orchitis	Genitourinary system
Genitourinary system, epididymitis	Genitourinary system
Genitourinary system, male infertility	Genitourinary system
Genitourinary system, azoospermia	Genitourinary system
Genitourinary system, oligospermia	Genitourinary system
Genitourinary system, prepuce	Genitourinary system
Genitourinary system, phimosis	Genitourinary system
Genitourinary system, paraphimosis	Genitourinary system
Genitourinary system, leukoplakia	Genitourinary system
Genitourinary system, balanoposthitis	Genitourinary system
Genitourinary system, balanitis	Genitourinary system
Genitourinary system, priapism	Genitourinary system
Genitourinary system, impotence	Genitourinary system
Genitourinary system, induratio penis plastica	Genitourinary system
Genitourinary system, peyronie's disease	Genitourinary system
Genitourinary system, inflammatory disorders of seminal vesicle	Genitourinary system
Genitourinary system, vesiculitis	Genitourinary system
Genitourinary system, benign mammary dysplasia	Genitourinary system
Genitourinary system, solitary cyst of breast	Genitourinary system
Genitourinary system, diffuse cystic mastopathy	Genitourinary system
Genitourinary system, fibroadenosis of breast	Genitourinary system
Genitourinary system, fibrosclerosis of breast	Genitourinary system
Genitourinary system, mammary duct ectasia	Genitourinary system
Genitourinary system, benign mammary dysplasias	Genitourinary system
Genitourinary system, mastitis	Genitourinary system
Genitourinary system, hypertrophy of breast	Genitourinary system
Genitourinary system, gynecomastia	Genitourinary system
Genitourinary system, lump in breast	Genitourinary system
Genitourinary system, fissure	Genitourinary system
Genitourinary system, fistula	Genitourinary system
Genitourinary system, fat necrosis of breast	Genitourinary system
Genitourinary system, atrophy of breast	Genitourinary system
Genitourinary system, galactorrhoea	Genitourinary system
Genitourinary system, mastodynia	Genitourinary system
Genitourinary system, induration of breast	Genitourinary system
Genitourinary system, nipple discharge	Genitourinary system
Genitourinary system, retraction of nipple	Genitourinary system
Genitourinary system, disorders of breast	Genitourinary system
Genitourinary system, galactocele	Genitourinary system
Genitourinary system, disorder of breast	Genitourinary system
Genitourinary system, salpingitis	Genitourinary system
Genitourinary system, oophoritis	Genitourinary system
Genitourinary system, hydrosalpinx	Genitourinary system
Genitourinary system, inflammatory disease	Genitourinary system
Genitourinary system, endometritis	Genitourinary system
Genitourinary system, endomyometritis	Genitourinary system
Genitourinary system, metritis	Genitourinary system
Genitourinary system, myometritis	Genitourinary system
Genitourinary system, pyometra	Genitourinary system
Genitourinary system, uterine abscess	Genitourinary system
Genitourinary system, cervix uteri	Genitourinary system
Genitourinary system, cervicitis	Genitourinary system
Genitourinary system, endocervicitis	Genitourinary system
Genitourinary system, exocervicitis	Genitourinary system
Genitourinary system, pelvic inflammatory diseases	Genitourinary system
Genitourinary system, parametritis	Genitourinary system
Genitourinary system, pelvic cellulitis	Genitourinary system
Genitourinary system, pelvic peritonitis	Genitourinary system
Genitourinary system, pelvic peritoneal adhesions	Genitourinary system
Genitourinary system, pelvic inflammatory disease	Genitourinary system
Genitourinary system, pelvic inflammatory disorders	Genitourinary system
Genitourinary system, bartholin's gland	Genitourinary system
Genitourinary system, vaginitis	Genitourinary system
Genitourinary system, vulvovaginal	Genitourinary system
Genitourinary system, ulceration of vulva in infectious and parasitic diseases	Genitourinary system
Genitourinary system, vaginitis	Genitourinary system
Genitourinary system, vulvitis and vulvovaginitis in infectious and parasitic diseases	Genitourinary system
Genitourinary system, vulvovaginal ulceration and inflammation in other diseases	Genitourinary system
Genitourinary system, endometriosis	Genitourinary system
Genitourinary system, adenomyosis	Genitourinary system
Genitourinary system, female genital prolapse	Genitourinary system
Genitourinary system, urethrocele	Genitourinary system
Genitourinary system, cystocele	Genitourinary system
Genitourinary system, rectocele	Genitourinary system
Genitourinary system, fistulae	Genitourinary system
Genitourinary system, vesicovaginal fistula	Genitourinary system
Genitourinary system, follicular cyst of ovary	Genitourinary system
Genitourinary system, corpus luteum cyst	Genitourinary system
Genitourinary system, ovarian cysts	Genitourinary system
Genitourinary system, acquired atrophy of ovary and fallopian tube	Genitourinary system
Genitourinary system, prolapse and hernia of ovary and fallopian tube	Genitourinary system
Genitourinary system, torsion of ovary	Genitourinary system
Genitourinary system, ovarian pedicle and fallopian tube	Genitourinary system
Genitourinary system, haematosalpinx	Genitourinary system
Genitourinary system, haematoma of broad ligament	Genitourinary system
Genitourinary system, polyp	Genitourinary system
Genitourinary system, polyp of corpus uteri	Genitourinary system
Genitourinary system, polyp of cervix uteri	Genitourinary system
Genitourinary system, endometrial glandular hyperplasia	Genitourinary system
Genitourinary system, endometrial adenomatous hyperplasia	Genitourinary system
Genitourinary system, hypertrophy of uterus	Genitourinary system
Genitourinary system, subinvolution of uterus	Genitourinary system
Genitourinary system, malposition of uterus	Genitourinary system
Genitourinary system, inversion of uterus	Genitourinary system
Genitourinary system, intrauterine synechiae	Genitourinary system
Genitourinary system, haematometra	Genitourinary system
Genitourinary system, erosion	Genitourinary system
Genitourinary system, ectropion	Genitourinary system
Genitourinary system, dysplasia	Genitourinary system
Genitourinary system, cervical dysplasia	Genitourinary system
Genitourinary system, dysplasia of cervix uteri	Genitourinary system
Genitourinary system, old laceration	Genitourinary system
Genitourinary system, stenosis	Genitourinary system
Genitourinary system, noninflammatory disorders of cervix uteri	Genitourinary system
Genitourinary system, noninflammatory disorder of cervix uteri	Genitourinary system
Genitourinary system, vaginal dysplasia	Genitourinary system
Genitourinary system, atresia	Genitourinary system
Genitourinary system, tight hymenal ring	Genitourinary system
Genitourinary system, haematocolpos	Genitourinary system
Genitourinary system, noninflammatory disorders of vagina	Genitourinary system
Genitourinary system, leukorrhoea	Genitourinary system
Genitourinary system, noninflammatory disorder of vagina	Genitourinary system
Genitourinary system, perineum	Genitourinary system
Genitourinary system, vulvar dysplasia	Genitourinary system
Genitourinary system, dysplasia of vulva	Genitourinary system
Genitourinary system, atrophy	Genitourinary system
Genitourinary system, hypertrophy	Genitourinary system
Genitourinary system, vulvar cyst	Genitourinary system
Genitourinary system, menstruation	Genitourinary system
Genitourinary system, amenorrhoea	Genitourinary system
Genitourinary system, oligomenorrhoea	Genitourinary system
Genitourinary system, excessive	Genitourinary system
Genitourinary system, frequent menstruation	Genitourinary system
Genitourinary system, regular cycle	Genitourinary system
Genitourinary system, menorrhagia	Genitourinary system
Genitourinary system, irregular cycle	Genitourinary system
Genitourinary system, menometrorrhagia	Genitourinary system
Genitourinary system, metrorrhagia	Genitourinary system
Genitourinary system, excessive menstruation	Genitourinary system
Genitourinary system, puberty	Genitourinary system
Genitourinary system, ovulation bleeding	Genitourinary system
Genitourinary system, excessive bleeding	Genitourinary system
Genitourinary system, premenopausal period	Genitourinary system
Genitourinary system, uterine	Genitourinary system
Genitourinary system, postcoital bleeding	Genitourinary system
Genitourinary system, abnormal uterine and vaginal bleeding	Genitourinary system
Genitourinary system, pain	Genitourinary system
Genitourinary system, female genital organs	Genitourinary system
Genitourinary system, mittelschmerz	Genitourinary system
Genitourinary system, dyspareunia	Genitourinary system
Genitourinary system, vaginismus	Genitourinary system
Genitourinary system, premenstrual tension syndrome	Genitourinary system
Genitourinary system, dysmenorrhoea	Genitourinary system
Genitourinary system, menopausal	Genitourinary system
Genitourinary system, perimenopausal	Genitourinary system
Genitourinary system, post-menopausal bleeding	Genitourinary system
Genitourinary system, climacteric	Genitourinary system
Genitourinary system, postmenopausal	Genitourinary system
Genitourinary system, atrophic vaginitis	Genitourinary system
Genitourinary system, artificial menopause	Genitourinary system
Genitourinary system, habitual aborter	Genitourinary system
Genitourinary system, female infertility	Genitourinary system
Genitourinary system, anovulation	Genitourinary system
Genitourinary system, tubal	Genitourinary system
Genitourinary system, cervical	Genitourinary system
Genitourinary system, male	Genitourinary system
Genitourinary system, artificial fertilization	Genitourinary system
Genitourinary system, infection	Genitourinary system
Genitourinary system, artificial insemination	Genitourinary system
Genitourinary system, hyperstimulation of ovaries	Genitourinary system
Genitourinary system, complications	Genitourinary system
Genitourinary system, attempted introduction of fertilized ovum	Genitourinary system
Genitourinary system, in vitro fertilization	Genitourinary system
Genitourinary system, attempted introduction of embryo	Genitourinary system
Genitourinary system, embryo transfer	Genitourinary system
Genitourinary system, complication	Genitourinary system
Genitourinary system, postprocedural	Genitourinary system
Genitourinary system, adhesions of vagina	Genitourinary system
Genitourinary system, prolapse of vaginal vault	Genitourinary system
Genitourinary system, hysterectomy	Genitourinary system
Genitourinary system, external stoma of urinary tract	Genitourinary system
Genitourinary system, postprocedural disorders of genitourinary system	Genitourinary system
Genitourinary system, residual ovary syndrome	Genitourinary system
Genitourinary system, postprocedural disorder of genitourinary system	Genitourinary system
Genitourinary system, kidney disease	Genitourinary system
Genitourinary system, glomerules	Genitourinary system
Genitourinary system, mesangial proliferative	Genitourinary system
Genitourinary system, endocapillary proliferative	Genitourinary system
Genitourinary system, membranoproliferative/mesangiocapillary	Genitourinary system
Genitourinary system, diabetic	Genitourinary system
Genitourinary system, amyloidosis	Genitourinary system
Genitourinary system, goodpasture's syndrome	Genitourinary system
Genitourinary system, type ii rpg	Genitourinary system
Genitourinary system, type iii hypersensitivity	Genitourinary system
Genitourinary system, post-streptococcal	Genitourinary system
Genitourinary system, lupus	Genitourinary system
Genitourinary system, dpgn	Genitourinary system
Genitourinary system, iga/berger	Genitourinary system
Genitourinary system, type iii rpg	Genitourinary system
Genitourinary system, pauci-immune	Genitourinary system
Genitourinary system, granulomatosis with polyangiitis	Genitourinary system
Genitourinary system, microscopic polyangiitis	Genitourinary system
Genitourinary system, eosinophilic granulomatosis with polyangiitis	Genitourinary system
Genitourinary system, glomerulonephritis	Genitourinary system
Genitourinary system, glomerulonephrosis	Genitourinary system
Genitourinary system, acute tubular necrosis	Genitourinary system
Genitourinary system, fanconi syndrome	Genitourinary system
Genitourinary system, bartter syndrome	Genitourinary system
Genitourinary system, gitelman syndrome	Genitourinary system
Genitourinary system, liddle's syndrome	Genitourinary system
Genitourinary system, interstitium	Genitourinary system
Genitourinary system, nephritis	Genitourinary system
Genitourinary system, nephrosis	Genitourinary system
Genitourinary system, chronic kidney disease	Genitourinary system
Genitourinary system, uremic pericarditis	Genitourinary system
Genitourinary system, uremia	Genitourinary system
Genitourinary system, diabetes insipidus	Genitourinary system
Genitourinary system, nephrogenic	Genitourinary system
Genitourinary system, renal papilla	Genitourinary system
Genitourinary system, renal papillary necrosis	Genitourinary system
Genitourinary system, major calyx	Genitourinary system
Genitourinary system, reflux nephropathy	Genitourinary system
Genitourinary system, vascular	Genitourinary system
Genitourinary system, renal artery stenosis	Genitourinary system
Genitourinary system, renal ischemia	Genitourinary system
Genitourinary system, hypertensive nephropathy	Genitourinary system
Genitourinary system, renovascular hypertension	Genitourinary system
Genitourinary system, renal cortical necrosis	Genitourinary system
Genitourinary system, analgesic nephropathy	Genitourinary system
Genitourinary system, abderhaldenâ€“kaufmannâ€“lignac syndrome	Genitourinary system
Genitourinary system, megaureter	Genitourinary system
Genitourinary system, hunner's ulcer	Genitourinary system
Genitourinary system, hemorrhagic cystitis	Genitourinary system
Genitourinary system, neurogenic bladder dysfunction	Genitourinary system
Genitourinary system, bladder sphincter dyssynergia	Genitourinary system
Genitourinary system, vesicoureteral reflux	Genitourinary system
Genitourinary system, non-gonococcal urethritis	Genitourinary system
Genitourinary system, meatal stenosis	Genitourinary system
Genitourinary system, obstructive uropathy	Genitourinary system
Genitourinary system, retroperitoneal fibrosis	Genitourinary system
Genitourinary system, urolithiasis	Genitourinary system
Genitourinary system, bladder stone	Genitourinary system
Genitourinary system, kidney stone	Genitourinary system
Genitourinary system, malakoplakia	Genitourinary system
Genitourinary system, testicular torsion	Genitourinary system
Genitourinary system, aspermia	Genitourinary system
Genitourinary system, asthenozoospermia	Genitourinary system
Genitourinary system, hyperspermia	Genitourinary system
Genitourinary system, hypospermia	Genitourinary system
Genitourinary system, necrospermia	Genitourinary system
Genitourinary system, teratospermia	Genitourinary system
Genitourinary system, epididymis	Genitourinary system
Genitourinary system, hematocele	Genitourinary system
Genitourinary system, prostatitis	Genitourinary system
Genitourinary system, acute prostatitis	Genitourinary system
Genitourinary system, chronic bacterial prostatitis	Genitourinary system
Genitourinary system, chronic prostatitis/chronic pelvic pain syndrome	Genitourinary system
Genitourinary system, asymptomatic inflammatory prostatitis	Genitourinary system
Genitourinary system, benign prostatic hyperplasia	Genitourinary system
Genitourinary system, prostate cancer	Genitourinary system
Genitourinary system, seminal vesicle	Genitourinary system
Genitourinary system, seminal vesiculitis	Genitourinary system
Genitourinary system, balanoposthitisÂ / balanitis	Genitourinary system
Genitourinary system, balanitis plasmacellularis	Genitourinary system
Genitourinary system, pseudoepitheliomatous keratotic and micaceous balanitis	Genitourinary system
Genitourinary system, sexual dysfunction	Genitourinary system
Genitourinary system, erectile dysfunction	Genitourinary system
Genitourinary system, penile cancer	Genitourinary system
Genitourinary system, penile fracture	Genitourinary system
Genitourinary system, balanitis xerotica obliterans	Genitourinary system
Genitourinary system, hematospermia	Genitourinary system
Genitourinary system, retrograde ejaculation	Genitourinary system
Genitourinary system, postorgasmic illness syndrome	Genitourinary system
Genitourinary system, nonpuerperal mastitis	Genitourinary system
Genitourinary system, subareolar abscess	Genitourinary system
Genitourinary system, granulomatous mastitis	Genitourinary system
Genitourinary system, duct ectasia of breast	Genitourinary system
Genitourinary system, chronic cystic mastitis	Genitourinary system
Genitourinary system, mammoplasia	Genitourinary system
Genitourinary system, adipomastia (lipomastia	Genitourinary system
Genitourinary system, pseudogynecomastia),breast hypertrophy	Genitourinary system
Genitourinary system, breast atrophy	Genitourinary system
Genitourinary system, micromastia	Genitourinary system
Genitourinary system, amastia	Genitourinary system
Genitourinary system, anisomastia	Genitourinary system
Genitourinary system, breast engorgement	Genitourinary system
Genitourinary system, galactorrhea	Genitourinary system
Genitourinary system, inverted nipple	Genitourinary system
Genitourinary system, cracked nipples	Genitourinary system
Genitourinary system, breast cyst	Genitourinary system
Genitourinary system, breast hematoma	Genitourinary system
Genitourinary system, breast lump	Genitourinary system
Genitourinary system, pseudoangiomatous stromal hyperplasia	Genitourinary system
Genitourinary system, tension	Genitourinary system
Genitourinary system, ptosis	Genitourinary system
Genitourinary system, fat necrosis	Genitourinary system
Genitourinary system, amazia	Genitourinary system
Genitourinary system, endometriosis of ovary	Genitourinary system
Genitourinary system, poor ovarian reserve	Genitourinary system
Genitourinary system, ovarian apoplexy	Genitourinary system
Genitourinary system, ovarian cyst	Genitourinary system
Genitourinary system, theca lutein cyst	Genitourinary system
Genitourinary system, ovarian hyperstimulation syndrome	Genitourinary system
Genitourinary system, ovarian torsion	Genitourinary system
Genitourinary system, fallopian tube obstruction	Genitourinary system
Genitourinary system, hematosalpinx	Genitourinary system
Genitourinary system, endometrium	Genitourinary system
Genitourinary system, asherman's syndrome	Genitourinary system
Genitourinary system, dysfunctional uterine bleeding	Genitourinary system
Genitourinary system, endometrial hyperplasia	Genitourinary system
Genitourinary system, endometrial polyp	Genitourinary system
Genitourinary system, hypomenorrhea	Genitourinary system
Genitourinary system, oligomenorrhea	Genitourinary system
Genitourinary system, dysmenorrhea	Genitourinary system
Genitourinary system, recurrent miscarriage	Genitourinary system
Genitourinary system, myometrium	Genitourinary system
Genitourinary system, parametrium	Genitourinary system
Genitourinary system, cervical incompetence	Genitourinary system
Genitourinary system, cervical polyp	Genitourinary system
Genitourinary system, cervical stenosis	Genitourinary system
Genitourinary system, nabothian cyst	Genitourinary system
Genitourinary system, hematometra	Genitourinary system
Genitourinary system, retroverted uterus	Genitourinary system
Genitourinary system, hematocolpos	Genitourinary system
Genitourinary system, hydrocolpos	Genitourinary system
Genitourinary system, leukorrhea	Genitourinary system
Genitourinary system, vaginal discharge	Genitourinary system
Genitourinary system, bacterial vaginosis	Genitourinary system
Genitourinary system, candidal vulvovaginitis	Genitourinary system
Genitourinary system, hypoactive sexual desire disorder	Genitourinary system
Genitourinary system, sexual arousal disorder	Genitourinary system
Genitourinary system, urogenital fistulas	Genitourinary system
Genitourinary system, ureterovaginal	Genitourinary system
Genitourinary system, vesicovaginal	Genitourinary system
Genitourinary system, obstetric fistula	Genitourinary system
Genitourinary system, rectovaginal fistula	Genitourinary system
Genitourinary system, pelvic congestion syndrome	Genitourinary system
Genitourinary system, bartholin's cyst	Genitourinary system
Genitourinary system, kraurosis vulvae	Genitourinary system
Genitourinary system, vestibular papillomatosis	Genitourinary system
Genitourinary system, vulvodynia	Genitourinary system
Genitourinary system, clitoral hood	Genitourinary system
Genitourinary system, clitoris	Genitourinary system
Genitourinary system, persistent genital arousal disorder	Genitourinary system
Infectious and parasitic diseases, infection	Infectious and parasitic diseases
Infectious and parasitic diseases, antibiotic	Infectious and parasitic diseases
Infectious and parasitic diseases, pathogen	Infectious and parasitic diseases
Drug Format, Small molecular	Drug Format
Drug Format, Large Molecule	Drug Format
Drug Format, Gene Therapy	Drug Format
Drug Format, Cellular Therapy	Drug Format
Drug Format, Digital Medicine	Drug Format
Drug Format, Medical Device	Drug Format
Drug Format, Therapeutic Vaccines	Drug Format
Drug Format, Vaccines	Drug Format
Drug Format, iRNA/miRNA	Drug Format
Small molecular, compound	Small molecular
Small molecular, small molecule	Small molecular
Large Molecule, antibody drug	Large Molecule
Large Molecule, protein drug	Large Molecule
Large Molecule, therapeutic antibody	Large Molecule
Large Molecule, therapeutic protein	Large Molecule
Large Molecule, biological drug	Large Molecule
Gene Therapy, gene therapy	Gene Therapy
Gene Therapy, adenovirus	Gene Therapy
Gene Therapy, AAV	Gene Therapy
Cellular Therapy, CAR-T	Cellular Therapy
Cellular Therapy, TCR	Cellular Therapy
Cellular Therapy, Cellular therapy	Cellular Therapy
Digital Medicine, mobile medical applications	Digital Medicine
Medical Device, medical device	Medical Device
Medical Device, 510(k)	Medical Device
Medical Device, 90/385/EEC	Medical Device
Medical Device, 93/42/EEC	Medical Device
Medical Device, 98/79/EC	Medical Device
Medical Device, 21 CFR 860	Medical Device
Therapeutic Vaccines, therapeutic vaccine	Therapeutic Vaccines
Therapeutic Vaccines, tumor vaccine	Therapeutic Vaccines
Vaccine, vaccine	Vaccine
siRNA/miRNA, siRNA	siRNA/miRNA
siRNA/miRNA, miRNA,	siRNA/miRNA
Mechanism of Action, Immunology	Mechanism of Action
Immunology, immune-checkpoint	Immunology
Immunology, immunisation,	Immunology
